# KaraokeParty Songlist: Fri Nov  1 02:27:30 CET 2013

Cruella De Vil	101 Dalmatians
36 Grad	2Raumwohnung
Kommt Zusammen	2Raumwohnung
Wir Trafen Uns In Einem Garten	2Raumwohnung
Wir Werden Sehen	2Raumwohnung
New Year's Day	2fabiola feat. Medusa
36 grad	2raumwohnung
Besser Gehts Nicht	2raumwohnung
Wir Trafen Uns In Einem Garten	2raumwohnung
Wir Werden Sehen	2raumwohnung
Be Like That	3 Doors Down
Going Down in Flames	3 Doors Down
Here Without You	3 Doors Down
It's Not My Time	3 Doors Down
Kryptonite	3 Doors Down
Loser	3 Doors Down
When I'm Gone	3 Doors Down
From Yesterday	30 Seconds To Mars
Starstrukk	3OH!3 feat. Katy Perry
What's Up?	4 Non Blondes - Whats Up
Let it Rain	4 Strings
In da club	50 Cent
Ci sono anchio	883
Io ci saro'	883
La dura legge del gol	883
La regina del celebrità	883
Nord Sud Ovest Est	883
Ti sento vivere	883
Fast Forward To 2012	A Day To Remember
Almost Lover	A Fine Frenzy
I Ran (So Far Away)	A Flock of Seagulls
Judith	A Perfect Circle
Mamma Mia	A-Teens
Super Trooper	A-Teens
Crying in the Rain	A-ha
Foot Of The Mountain	A-ha
Summer Moved On	A-ha
Zai Jian [VIDEO]	A-yue Chang
Dancing Queen	ABBA
Gimme Gimme Gimme	ABBA
Honey, Honey	ABBA
I Have A Dream	ABBA
Knowing Me, Knowing You	ABBA
Lay All Your Love On Me	ABBA
Mamma Mia	ABBA
Thank You For The Music	ABBA
The Winner Takes It All	ABBA
Waterloo	ABBA
Back in Black (Live)	AC/DC
Dirty deeds done dirt cheap (Live)	AC/DC
Fire your Guns (Live)	AC/DC
For those about to Rock (We salute you) (Live)	AC/DC
Heatseeker (Live)	AC/DC
Hell ain't a bad place to be (Live)	AC/DC
Hells Bells (Live)	AC/DC
High Voltage (Live)	AC/DC
Highway to Hell (Live)	AC/DC
Jailbreak (Live)	AC/DC
Let there be Rock (Live)	AC/DC
Moneytalks (Live)	AC/DC
Shoot to Thrill (Live)	AC/DC
T.N.T. (Live)	AC/DC
The Jack (Live)	AC/DC
Thunderstruck (Live)	AC/DC
Whole lotta Rosie (Live)	AC/DC
You shook me all night long (Live)	AC/DC
6 to 8	AFI
But Home Is Nowhere	AFI
Try Again	Aaliyah
Irgendwie Irgendwo Irgendwann	Absolute Beginner
Highway To Hell	Ac/dc
All That She Wants	Ace of Base
Beautiful Life	Ace of Base
C'est La Vie	Ace of Base
The Sign	Ace of Base
Whataya Want From Me	Adam Lambert
One Song Glory	Adam Pascal
Killer	Adamski
Chasing Pavements	Adele
Rolling in the Deep	Adele
Rumour Has It	Adele
Set Fire To The Rain	Adele
Someone Like You	Adele
Azzurro	Adriano Celentano
Hai bucato la mia vita	Adriano Celentano
Il ragazzo della via gluck	Adriano Celentano
L'emozione non ha voce	Adriano Celentano
Soli	Adriano Celentano
Una carezza in un pugno	Adriano Celentano
Ricominciamo	Adriano Pappalardo
Crazy	Aerosmith
Don't want to miss a Thing	Aerosmith
Dream On	Aerosmith
Pink	Aerosmith
Ami-Oh	African Connection
Never Let It Go	Afrodite
Because I Got High	Afroman
La Dolce Vita	After Dark
Beetween Love And Fire	After Forever
Follow In The Cry	After Forever
Wir sind Werder Bremen [VIDEO]	Afterburner
Release Me	Agnes
Take on me	Aha
Take on me (Karaoke)	Aha
Tori no Uta	Air
Aozora	Air - Lia
All Out Of Love	Air Supply
All Out Of Love [VIDEO]	Air Supply
Shoujo Meiro De Tsukamaete (TV)	Aki Misato
Naispaholainen	Aki Sirkesalo
Angel	Akon
Lonely	Akon
Right now (Na na na)	Akon
Smack That feat. Eminem	Akon
Beautiful	Akon ft. Kardinal Offishal & Colby O Donis
Felicità	Al Bano & Romina Power
A Whole New World (Aladdin)	Aladdin
A Whole New World (Jasmine)	Aladdin
Ein Traum Wird Wahr	Aladdin
Prinz Ali	Aladdin
Il Mondo è Mio	Aladdin'
Chattahoochee	Alan Jackson
Good Time	Alan Jackson
Figli delle stelle	Alan Sorrenti
Hands clean [VIDEO]	Alanis Morissette
Ironic	Alanis Morissette
Thank U [VIDEO]	Alanis Morissette
That I Would Be Good	Alanis Morissette
You Learn	Alanis Morissette
You oughta know	Alanis Morissette
Black Velvet	Alannah Myles
It Never Rains In Southern California	Albert Hammond
It Never Rains In Southern California.mp3	Albert Hammond
Not A Sinner, Nor A Saint	Alcazar
This is the world we live in	Alcazar
Endlich Daheim	Alec, Scotch & Smart
No es lo mismo	Alejandro Sanz
The boy does nothing	Alesha Dixon
Du Hast Den Schönsten Arsch Der Welt	Alex C. Feat. Y-Ass
Du Bist So Porno	Alex C. feat. Y-ass
Destination Calabria	Alex Gaudino feat Crystal Waters
Under	Alex Hepburn
Ring um die Eier	Alex Knoll
Sin miedo a nada	Alex Ubago
Take Me Tonight	Alexander
Kiss Goodbye [VIDEO]	Alexander Wang
All Night Long	Alexandra Burke Feat Pitbull
Bad Boys	Alexandra Burke ft. Flo Rida
Mr. Saxobeat	Alexandra Stan
Da Grande	Alexia
Warum Bin Ich So Fröhlich?	Alfred J. Kwak
Bed Of Nails	Alice Cooper
No More Mr. Nice Guy	Alice Cooper
Poison	Alice Cooper
Poison [VIDEO]	Alice Cooper
School's Out	Alice Cooper
Would	Alice In Chains
Man in The Box	Alice in Chains
Would	Alice in Chains
Fallin'	Alicia Keys
No One	Alicia Keys
Smooth Criminal	Alien Ant Farm
All Cried Out	Alison Moyet
I Swear	All 4 One
Black Coffee	All Saints
Black Coffee [VIDEO]	All Saints
Never Ever	All Saints
Pure Shores [VIDEO]	All Saints
Ich Vermiss Dich (Wie Die Hölle)	Almklausi
Lo Lo Los Gehts	Almklausi
Loving You Is Killing Me	Aloe Blacc
Big In Japan	Alphaville
Forever Young [VIDEO]	Alphaville
Bad Apple!	Alstroemeria Records
Metalingus	Alter Bridge
I'll believe (TV)	Altima
Potential Break Up Song	Aly & AJ
Sin tí no soy nada	Amaral
Brainstorm	Amarillo
A Horse With No Name	America
The last unicorn	America
Youre sixteen Youre beautiful!!	American Graffitti
One Thing	Amerie
One Thing [VIDEO]	Amerie
Knock On Wood	Amii Stewart
Cry of the black birds	Amon Amarth
Let's Start A Band	Amy MacDonald
Mr Rock And Roll	Amy Macdonald
This is the Life	Amy Macdonald
Back To Black	Amy Winehouse
Back To Black [VIDEO]	Amy Winehouse
Love is a losing game [VIDEO]	Amy Winehouse
Rehab	Amy Winehouse
Tears Dry On Their Own	Amy Winehouse
I'm Outta Love [VIDEO]	Anastacia
Left Outside Alone	Anastacia
Left Outside Alone [VIDEO]	Anastacia
One Day In Your Life [VIDEO]	Anastacia
Pieces Of A Dream	Anastacia
Sick And Tired [VIDEO]	Anastacia
Ich Liebe Das Leben	Andrea Berg
Vivo per lei	Andrea Bocelli feat. Giorgia
Nur In Meinem Kopf	Andreas Bourani
Fred vom Jupiter	Andreas Dorau und die Marinas
Ich Fang Dir Den Mond	Andreas Martin
Stille Nacht	Andy Borg
C Da Diao [VIDEO]	Angela Zhang
House Of The Rising Sun	Animals
2 Times	Ann Lee
ABC (Schwedisch)	Anna Book
Moje Jedyne Marzenie	Anna Jantar
1000 Träume Weit	Anna Maria Zimmermann
Frei Sein	Anna Maria Zimmermann
Donna Con Te	Anna Oxa
Dimmi dimmi	Anna Tatangelo
Quando due si lasciano	Anna Tatangelo
cosa ne sai	Anna Tatangelo
Ragazza di periferia	Anna tatangelo
Wer Ist Dieser DJ	Anna-Maria Zimmermann
Das Gefühl [VIDEO]	Annett Louisan
Das Spiel	Annett Louisan
Das Spiel [VIDEO]	Annett Louisan
Barbapapas	Annette Tison
Heartbeat	Annie
Into the West	Annie Lennox
Sweet Dreams	Annie Lennox
Milla	Anssi Kela
Got The Time	Anthrax
Alta Marea	Antonello Venditti
Che c'è	Antonello Venditti
Barbie Girl	Aqua
ALONES	Aqua Timez
I Bet you Look Good on the Dance Floor	Arctic Monkeys
Respect	Aretha Franklin
Respect [VIDEO]	Aretha Franklin
Nur Ein Kuss	Arielle
Unten Im Meer	Arielle
Katzen Brauchen Furchtbar Viel Musik	Aristocats
Högt Över Havet	Arja Saijonmaa
Rumadai	Arsenium
Bright Eyes	Art Garfunkel
L'italiano Medio	Articolo 31
La mia ragazza mena	Articolo 31
Tocca qui	Articolo 31
Eloise	Arvingarna
Girl From Mars	Ash
Solid (Ashford)	Ashford & Simpson
Solid (Simpson)	Ashford & Simpson
Boyfriend	Ashlee Simpson
La La [VIDEO]	Ashlee Simpson
Pieces Of Me	Ashlee Simpson
Heat Of The Moment	Asia
After dark	Asian Kung-fu Generation
Haruka kanata	Asian Kung-fu Generation
Haruka kanata (TV)	Asian Kung-fu Generation
Rewrite	Asian Kung-fu Generation
Du käre lille snickerbo	Astrid Lindgren
Idas sommarvisa	Astrid Lindgren
Pippi Langstrumpf	Astrid Lindgren
Pilutta-visan	Astrid Lindgren (Madicken)
Eye Of The Tiger	At Vance
Money, Money, Money	At Vance
Ufo Robot	Atlas
Eternal Flame	Atomic Kitten
Eternal Flame (Karaoke)	Atomic Kitten
Eternal Flame (Karaoke) [VIDEO]	Atomic Kitten
Eternal Flame [VIDEO]	Atomic Kitten
The Last Goodbye [VIDEO]	Atomic Kitten
The Tide is high [VIDEO]	Atomic Kitten
Whole Again [VIDEO]	Atomic Kitten
Storm To Pass	Atreyu
Ooa Hela Natten	Attack
Atzin	Atzen
Cochise	Audioslave
A Little Piece Of Heaven	Avenged Sevenfold
Almost Easy	Avenged Sevenfold
Bat Country	Avenged Sevenfold
Beast and the Harlot	Avenged Sevenfold
Obsesion	Aventura
The Internet Is For Porn [VIDEO]	Avenue Q
There's a Fine, Fine Line	Avenue Q
Levels	Avicii
Complicated	Avril Lavigne
Complicated (Karaoke)	Avril Lavigne
Complicated (Karaoke) [VIDEO]	Avril Lavigne
Complicated [VIDEO]	Avril Lavigne
Don't tell me	Avril Lavigne
Girlfriend	Avril Lavigne
He wasn't	Avril Lavigne
Hot [VIDEO]	Avril Lavigne
How does it feel	Avril Lavigne
I'm With You	Avril Lavigne
I'm With You [VIDEO]	Avril Lavigne
My Happy Ending	Avril Lavigne
My Happy Ending [VIDEO]	Avril Lavigne
Nobody's home [VIDEO]	Avril Lavigne
Sk8er Boi	Avril Lavigne
When You're Gone [VIDEO]	Avril Lavigne
Amsterdam	Axel Fischer
Zum Geburtstag	Axel Kurth
Mein Stern	Ayman
Sólo Se Vive Una Vez	Azúcar Moreno
C'est La Vie	B*Witched
Love Shack	B-52's
Blame It On The Weatherman	B-Witched
Raindrops Keep Fallin' On My Head	B. J. Thomas
Nothin' on you	B.O.B ft. Bruno Mars
Leuchte auf, Borussia	BVB Borussia Dortmund
Britney Spears	Baby One More Time
You Ain't Seen Nothing Yet	Bachman Turner Overdrive
As Long As You Love Me	Backstreet Boys
Everybody	Backstreet Boys
I Want It That Way	Backstreet Boys
I'll Never Break Your Heart	Backstreet Boys
Quit playing games with my heart [VIDEO]	Backstreet Boys
Shape of my heart	Backstreet Boys
The Call	Backstreet Boys
Feel Like Makin' Love	Bad Company
Lighters	Bad Meets Evil ft. Bruno Mars
American Jesus	Bad Religion
Big Bang	Bad Religion
Generator	Bad Religion
Walk Away	Bad Religion
You	Bad Religion
Way Back Home	Bag Raiders
Tarzan Boy	Baltimora
Easy Day	Bananafishbones & Franka Potente
I Heard A Rumour	Bananarama
Venus	Bananarama
Venus (Karaoke)	Bananarama
Dubi Dam Dam [VIDEO]	Banaroo
Do they know it's Christmas	Band Aid
Manic Monday	Bangles
Kom Hem	Barbados
Världen Utanför	Barbados
Woman In Love	Barbara Streisand
One Week	Barenaked Ladies
Copacabana	Barry Manilow
Mandy	Barry Manilow
You're The First, The Last, My Everything	Barry White
You're The First, The Last, My Everything [VIDEO]	Barry White
Boten Anna	Basshunter
Loituma Remix	Basshunter
Charlie fa surf	Baustelle
Surfin USA	Beach Boys
Wouldn't It Be Nice	Beach Boys
Dreh Dich Um Und Geh	Beatplanet
Hand In Hand	Beatsteaks
I don't care as long as you sing	Beatsteaks
Beauty And The Beast	Beauty And The Beast
E-Pro	Beck
Girl	Beck
How Deep Is Your Love	Bee Gees
Massachussets [VIDEO]	Bee Gees
Stayin' Alive	Bee Gees
Tragedy	Bee Gees
Words	Bee Gees
You Should Be Dancing [VIDEO]	Bee Gees
1. 2. 3. ...	Bela B.
Heaven Is A Place On Earth	Belinda Carlisle
Let Your Love Flow	Bellamy Brothers
Stand By Me	Ben E. King
Spring	Ben Jammin
Spring	Ben*Jammin
Battlefield	Berlin Mitte
Der Junge Mit Der Mundharmonika	Bernd Cluver
Mi curro en la ONCE	Berni
Dime	Beth
From A Distance	Bette Midler
The Rose	Bette Midler
Come As You Are [VIDEO]	Beverly Knight
Crazy In Love	Beyonc
Halo	Beyonce
If I Were A Boy	Beyonce
Irreplaceable	Beyonce
Listen	Beyonce
Naughty Girl [VIDEO]	Beyonce
Single ladies (Put a ring on it)	Beyonce
Video Phone	Beyonce feat. Lady Gaga
Beautiful Liar	Beyonce feat. Shakira
Crazy In Love	BeyoncÃ©
Video Phone	Beyoncé feat. Lady Gaga
Beautiful Liar (Duett)	Beyoncé feat. Shakira
Coccinella	Biagio Antonacci
Convivendo	Biagio Antonacci
Save a Horse	Big And Rich
See You Later Alligator	Bill Haley & The Comets
I'Ve Had The Time Of My Life	Bill Medley & Jennifer Warnes
Ain't No Sunshine	Bill Withers
Ain't No Sunshine (Karaoke)	Bill Withers
Ain't No Sunshine (Karaoke) [VIDEO]	Bill Withers
Ain't No Sunshine [VIDEO]	Bill Withers
Rebel Yell	Billy Idol
White Wedding	Billy Idol
A Matter of Trust	Billy Joel
Honesty	Billy Joel
My Life	Billy Joel
Piano Man	Billy Joel
Tell her about it	Billy Joel
The Longest Time	Billy Joel
Uptown Girl	Billy Joel
Uptown Girl [VIDEO]	Billy Joel
We Didn't Start The Fire	Billy Joel
Caribbean Queen	Billy Ocean
Achy Breaky Heart	Billy Ray Cyrus
Achy Breaky Heart [VIDEO]	Billy Ray Cyrus
Devil In A Midnight Mass	Billy Talent
Fallen Leaves	Billy Talent
Nothing To Lose	Billy Talent
Red Flag	Billy Talent
Rusted from the Rain	Billy Talent
Surrender	Billy Talent
Tears Into Wine	Billy Talent
The Ex	Billy Talent
Try Honesty	Billy Talent
White Christmas	Bing Crosby
Mama Leone	Bino
People Help The People	Birdy
Wonderful Life	Black
Don't Lie	Black Eyed Peas
Hey Mama	Black Eyed Peas
I Gotta Feeling	Black Eyed Peas
Pump It [VIDEO]	Black Eyed Peas
Shut Up	Black Eyed Peas
Where Is The Love	Black Eyed Peas
Bye, Bye My Love	Black Fööss
Inget kan stoppa oss nu	Black Jack
Iron man	Black Sabbath
Paranoid	Black Sabbath
Fallen Angels	Black Veil Brides
Perfect Weapon	Black Veil Brides
Shadow Of The Moon	Blackmore's Night
Home	Blake Shelton
A Past And Future Secret	Blind Guardian
And The Story Ends	Blind Guardian
Another Stranger Me	Blind Guardian
Black Chamber	Blind Guardian
Fly	Blind Guardian
Mirror Mirror	Blind Guardian
Surfin' Usa	Blind Guardian
The Bard's Song (in The Forest)	Blind Guardian
Time What Is Time	Blind Guardian
To France	Blind Guardian
When Sorrow Sang	Blind Guardian
No Rain	Blind Melon
All the small things [VIDEO]	Blink 182
Always	Blink 182
Dammit	Blink 182
First Date	Blink 182
I Miss You	Blink 182
Josie	Blink 182
Shut Up	Blink 182
Stay Together For The Kids	Blink 182
What's My Age Again?	Blink 182
What's My Age Again?	Blink-182
Banquet	Bloc Party
Atomic	Blondie
Heart Of Glass	Blondie
Heart Of Glass (Karaoke)	Blondie
Heart of Glass	Blondie
Maria	Blondie
The Tide Is High	Blondie
The Tide Is High [VIDEO]	Blondie
Tell me it's not true	Blood Brothers
Fire Water Burn	Bloodhound Gang
Foxtrott Uniform Charlie Kilo	Bloodhound Gang
The Bad Touch [VIDEO]	Bloodhound Gang
The Ballad of Chasey Lane	Bloodhound Gang
Uhn Tiss Uhn Tiss Uhn Tiss	Bloodhound Gang
Hit 'Em Up Style	Blu Cantrell
Breathe Easy	Blue
Guilty	Blue
I Can	Blue
One Love	Blue
One Love (Karaoke)	Blue
One Love (Karaoke) [VIDEO]	Blue
One Love [VIDEO]	Blue
Don't Fear The Reaper	Blue Oyster Cult
(Don't Fear) The Reaper	Blue Öyster Cult
Everybody Needs Somebody To Love	Blues Brothers
Everybody needs somebody to love	Blues Brothers
Girls & Boys	Blur
Girls & Boys [VIDEO]	Blur
Parklife	Blur
Parklife [VIDEO]	Blur
Song 2	Blur
Kleiner Satellit [VIDEO]	Blümchen
Lay Lady Lay	Bob Dylan
Mr Tambourine Man	Bob Dylan
Could you be loved	Bob Marley
No Woman No Cry	Bob Marley
Redemption Song	Bob Marley & The Wailers
Love Generation	Bob Sinclar
Ginny Comes Lately	Bobby Darin
Don't Worry Be Happy	Bobby McFerrin
Sealed With A Kiss	Bobby Vinton
Take A Good Care Of My Baby	Bobby Vinton
Liebeslied	Bodo Wartke
Always	Bon Jovi
Bad medicine	Bon Jovi
Bed of Roses	Bon Jovi
Blaze of Glory	Bon Jovi
Everyday	Bon Jovi
I'd die for you	Bon Jovi
It's My Life [VIDEO]	Bon Jovi
Keep the faith	Bon Jovi
Livin' on a prayer	Bon Jovi
Runaway	Bon Jovi
Someday I'll be Saturday Night	Bon Jovi
Wanted dead or alive	Bon Jovi
You Give Love A Bad Name	Bon Jovi
You want to make a memory	Bon Jovi
By the rivers of Babylon	Boney M.
Daddy Cool	Boney M.
Ma Baker	Boney M.
Ma Baker (BACKING F)	Boney M.
Ma Baker (LEAD M)	Boney M.
Holding Out For A Hero [VIDEO]	Bonnie Tyler
Its A Heartache	Bonnie Tyler
Total Eclipse of the Heart	Bonnie Tyler
Total Eclipse of the Heart [VIDEO]	Bonnie Tyler
Shine	Booty Luv
Schönste Zeit	Bosse
More Than A Feeling	Boston
Was wollen wir trinken	Bots
1985	Bowling For Soup
High School Never Ends	Bowling For Soup
Waiting For A Star To Fall	Boy Meets Girl
Hej Soko³y	Boys
The Great Escape	Boys Like Girls
Baby Can I Hold You	Boyzone
No Matter What [VIDEO]	Boyzone
Words	Boyzone
Online	Brad Paisley
Kom Och Ta Mig	Brandsta City Släckers
Kom o ta mig	Brandsta City Släckers
Right Here (Departed)	Brandy
Za Wielkim Morzem	Brathanki
Rockin' Around The Christmas Tree	Brenda Lee
Halleluja	Brings
(You Drive Me) Crazy	Britney Spears
3	Britney Spears
Baby one more time	Britney Spears
Circus	Britney Spears
Criminal	Britney Spears
Don't Let Me Be The Last To Know [VIDEO]	Britney Spears
Everytime [VIDEO]	Britney Spears
Gimme more	Britney Spears
I Love Rock 'n Roll	Britney Spears
I'm Not A Girl, Not Yet A Woman	Britney Spears
I'm Slave 4 U	Britney Spears
If U Seek Amy	Britney Spears
Im Not A Girl, Not Yet A Woman [VIDEO]	Britney Spears
Lucky	Britney Spears
My Prerogative [VIDEO]	Britney Spears
Oops! I did it again	Britney Spears
Overprotected	Britney Spears
Piece Of Me	Britney Spears
Sometimes [VIDEO]	Britney Spears
Toxic	Britney Spears
What U See (Is What U Get)	Britney Spears
Womanizer	Britney Spears
Do You	Bro'sis
Ruby Light & Dark	Broilers
Something In The Water	Brooke Fraser
Boot Scootin' Boogie	Brooks & Dunn
If You See Him If You See Her	Brooks & Dunn
Tears Of The Dragon	Bruce Dickinson
Es hängt ein Pferdehalfter an der Wand	Bruce Low
Born To Run	Bruce Springsteen
Dancing in the Dark	Bruce Springsteen
I'm On Fire	Bruce Springsteen
Streets of Philadelphia	Bruce Springsteen
The River	Bruce Springsteen
Talking To The Moon	Bruno Mars
The Lazy Song	Bruno Mars
Bryan Adams-Summer of '69	Bryan Adams
Cloud Number Nine	Bryan Adams
Everything I Do (I Do It For You)	Bryan Adams
Have you ever really loved a woman	Bryan Adams
Heaven	Bryan Adams
I Do It For You [VIDEO]	Bryan Adams
Please Forgive Me	Bryan Adams
Making Your Mind Up	Bucks Fizz
It's Good To Be Us	Bucky Covington
Ab In Den Süden 2004	Buddy
Ab in den Süden	Buddy
Oh boy	Buddy Holly
Peggy Sue	Buddy Holly
Video Killed The Radio Star	Buggles
All These Things I Hate (revolve Around Me)	Bullet For My Valentine
Swallowed	Bush
Crashed The Wedding	Busted
Crashed the Wedding	Busted
Crashed the Wedding (Karaoke)	Busted
Year 3000 [VIDEO]	Busted
Auf gute Freunde	Böhse Onkelz
Bin ich nur glücklich...	Böhse Onkelz
Bomberpilot	Böhse Onkelz
Die Firma	Böhse Onkelz
Dr. Martens Beat	Böhse Onkelz
Dunkler Ort	Böhse Onkelz
Ich bin in Dir	Böhse Onkelz
Mexico	Böhse Onkelz
Nichts Ist Für Die Ewigkeit	Böhse Onkelz
Nur die Besten sterben jung	Böhse Onkelz
Schöne neue Welt	Böhse Onkelz
Stunde des Siegers	Böhse Onkelz
Terpentin	Böhse Onkelz
Wir sind immer für euch da	Böhse Onkelz
Zeit zu gehn	Böhse Onkelz
Zuviel	Böhse Onkelz
Bad Moon Rising	CCR
Down On The Corner	CCR
Hey Tonight	CCR
Jerk It Out [VIDEO]	Caesars
La Lola	Café Quijano
Frank Sinatra	Cake
Sweet Nothing	Calvin Harris ft. Florence Welch
Young Hearts Run Free	Candi Staton
Erase and Rewind	Cardigans
Lovefool	Cardigans
My Favourite Game	Cardigans
Kung Fu Fighting	Carl Douglas
Kung Fu Fighting (Karaoke)	Carl Douglas
Kung Fu Fighting (Karaoke) [VIDEO]	Carl Douglas
Kung Fu Fighting [VIDEO]	Carl Douglas
This Kiss	Carly Rae Jepsen
A Night Like This	Caro Emerald
Främling	Carola Häggkvist
Durch meine Finger rinnt die Zeit	Caroline Fortenbacher
(They Long To Be) Close To You	Carpenters
Jambalaya	Carpenters
Lose It	Cartel
A Neverending Dream	Cascada
Because The Night	Cascada
Evacuate The Dancefloor	Cascada
Everytime We Touch	Cascada
Everytime We Touch [VIDEO]	Cascada
Miracle [VIDEO]	Cascada
Truly Madly Deeply	Cascada
What do you want from me [VIDEO]	Cascada
Darum Leben Wir	Cassandra Steen
Father and Son	Cat Stevens
Morning has broken	Cat Stevens
Sad Lisa	Cat Stevens
Memory	Cats
If That's What It Takes	Celine Dion
My Heart Will Go On (Karaoke) [VIDEO]	Celine Dion
My Heart Will Go On [VIDEO]	Celine Dion
Pour Que Tu M'Aimes Encore	Celine Dion
The Power Of Love	Celine Dion
Beauty and the Beast	Celine Dion & Peabo Bryson
20 de Abril del 90	Celtas Cortos
Hero	Chad Kroeger & Josey Scott
I've Never Been To Me	Charlene
Would I Lie To You (Charles)	Charles & Eddie
Would I Lie To You (Eddie)	Charles & Eddie
Like a hobo	Charlie Winston
Crazy Chick	Charlotte Church
Take Me to Your Heaven	Charlotte Nilsson
Tusen Och En Natt	Charlotte Nilsson
Hallå Hela Pressen	Chattanooga
I Want You To Want Me	Cheap Trick
Aiyscha	Cheb Khaled
El alma en pie	Chenoa & David Bisbal
Believe	Cher
If I Could Turn Back Time	Cher
Strong Enough [VIDEO]	Cher
Parachute	Cheryl Cole
The One And Only	Chesney Hawkes
The One And Only [VIDEO]	Chesney Hawkes
If you leave me now	Chicago
Wishful Thinking	China Crisis
Yasashisa no Riyuu	ChouCho
Pretty Belinda (Deutsch)	Chris Andrews
Pretty Belinda (English)	Chris Andrews
Yo (Excuse Me Miss) [VIDEO]	Chris Brown
With You (Official Remix)	Chris Brown feat. Karina Pasian
You Know My Name	Chris Cornell
Lady in red	Chris DeBurgh
Santa Maria	Chris Marlow
Midnight Lady	Chris Norman
Die Hände zum Himmel	Chris Rabatz ft. The Kingz
Driving Home For Christmas	Chris Rea
Du Kannst Nicht Immer 17 Sein	Chris Roberts
Amazing Grace (My Chains Are Gone)	Chris Tomlin
lou xia na ge nv ren [VIDEO]	Chris Yu
A Womans Heart	Chris de Burgh
The Lady in Red	Chris de Burgh
Det Hon Vill Ha	Christer Sandelin
Never Be Afraid Again	Christian Walz
Ain't No Other Man [VIDEO]	Christina Aguilera
Beautiful [VIDEO]	Christina Aguilera
Come On Over Baby (All I Want Is You)	Christina Aguilera
Dirrty	Christina Aguilera
Dirrty [VIDEO]	Christina Aguilera
Fighter [VIDEO]	Christina Aguilera
Genie in a Bottle	Christina Aguilera
Hurt (Chris Cox Vocal Anthem Mix)	Christina Aguilera
Hurt (Chris Cox Vocal Anthem Mix) [VIDEO]	Christina Aguilera
Hurt (Karaoke) [VIDEO]	Christina Aguilera
Hurt [VIDEO]	Christina Aguilera
Keeps Gettin' Better	Christina Aguilera
The Voice Within [VIDEO]	Christina Aguilera
Your Body	Christina Aguilera
Nobody Wants To Be Lonely	Christina Aguilera & Ricky Martin
AM to PM [VIDEO]	Christina Milian
Ich Lebe	Christina Stuermer
Ich Lebe 2005	Christina Stuermer
Engel Fliegen Einsam [VIDEO]	Christina Stürmer
Ich Lebe 2005	Christina Stürmer
Ich Lebe 2005 [VIDEO]	Christina Stürmer
Immer An Euch Geglaubt	Christina Stürmer
Scherbenmeer	Christina Stürmer
Karl-Heinz	Christoph & Lollo
Ride On	Christy Moore
Lets Twist Again	Chubby Checker
Johnny B. Goode	Chuck Berry
Tubthumping	Chumbawamba
Tubthumping [VIDEO]	Chumbawamba
Promise	Ciara
One Two Step	Ciara feat Missy Elliot
Love & Sexy Magic	Ciara feat.Justin Timberlake
Bibbidi Babbidi Bu	Cinderella
Bibbidi Bobbidi Boo	Cinderella
The Work Song	Cinderella
Immer Wieder Sonntags	Cindy & Bert
Lovesongs (They Kill Me)	Cinema Bizarre
Avrai	Claudio Baglioni
Mille giorni di te e di me	Claudio Baglioni
Devil Woman	Cliff Richard
Saviour's day	Cliff Richard
Lucky Lips	Cliff Richards
Living Doll	Cliff Richards & The Shadows
Chicago	Clueso
Gewinner	Clueso
Kein Bock Zu Geh'n	Clueso
Vergessen ist so leicht	Clueso
Bubbly	Colbie Caillat
Charlie Brown	Coldplay
Clocks	Coldplay
Every Teardrop Is A Waterfall	Coldplay
Paradise	Coldplay
Speed Of Sound	Coldplay
Talk	Coldplay
The Hardest Part	Coldplay
The Scientist [VIDEO]	Coldplay
Viva La Vida	Coldplay
Yellow	Coldplay
Schöner fremder Mann	Connie Francis
Pack die Badehose ein	Conny Froboess
Undo	Cool Joke
Gangsta's Paradise	Coolio
I'd Like To	Corinne Bailey Rae
Put Your Records On	Corinne Bailey Rae
Anita	Costa Cordalis
Otra Vez	Coti
Nada fue un error	Coti & Andrés Calamaro
Colorblind	Counting Crows
Fill Me In	Craig David
Walking Away	Craig David
Rise And Fall	Craig David Feat Sting
Zombie	Cranberries
Linger	Cranberries (The)
Ode to My Family	Cranberries (The)
God Shuffled His Feet	Crash Test Dummies
MMM MMM MMM MMM	Crash Test Dummies
MMM MMM MMM MMM MMM	Crash Test Dummies
Johana Shut Up	Crazy Loop
Mma ma ma	Crazy Loop
One Last Breath	Creed
With Arms Wide Open	Creed
Have you ever seen the rain	Creedence Clearwater
Hey Tonight	Creedence Clearwater Revival
Lookin' Out My Backdoor	Creedence Clearwater Revival
Wann Wirds Mal Wieder Richtig Sommer	Creme 21
What's my destiny	Cristina Davena & Giorgio Vanni
Easy	Cro
Einmal um die Welt	Cro
Don't Dream It's Over	Crowded House
Ai wo Torimodose!!	Crystal King
Berlin City Girl	Culcha Candela
Eiskalt	Culcha Candela
Ey DJ	Culcha Candela
Hamma	Culcha Candela
Monsta	Culcha Candela
Von Allein	Culcha Candela
Do You Really Want To Hurt Me	Culture Club
Do You Really Want to Hurt Me?	Culture Club
Karma Chameleon	Culture Club
Karma Chameleon [VIDEO]	Culture Club
(I Just) Died In Your Arms	Cutting Crew
Died In Your Arms [VIDEO]	Cutting Crew
Girls Just Wanna Have Fun	Cyndi Lauper
She Bop	Cyndi Lauper
Time After Time	Cyndi Lauper
Time After Time [VIDEO]	Cyndi Lauper
Chihuahua 2002 [VIDEO]	DJ Bobo
What A Feeling	DJ Bobo Feat. Irene Cara
Summertime	DJ Jazzy Jeff & The Fresh Prince
Summertime [VIDEO]	DJ Jazzy Jeff &amp
Hey Baby	DJ Otzi
Live Is Life (BACKING M)	DJ Otzi
Live Is Life (LEAD M)	DJ Otzi
Anton Aus Tirol	DJ Ötzi
Anton aus Tirol	DJ Ötzi
Ein Stern (Der Deinen Namen Trägt)	DJ Ötzi & Nik P.
Party Palmen Weiber Und n Bier	DJ-Abschleppdienst
Tom's Diner (DNA Remix)	DNA Feat. Suzanne Vega
Digital Love [VIDEO]	Daft Punk
Get Lucky	Daft Punk
One More Time	Daft Punk
Technologic [VIDEO]	Daft Punk
Daitarn III	Daitarn III
Run For The Roses	Dan Fogelberg
Moonlight Shadow	Dana Winner
If You're Not The One	Daniel Bedingfield
If You're Not the One	Daniel Bedingfield
If You're Not the One (Karaoke)	Daniel Bedingfield
Coming True	Daniel Lindström
Bad Day	Daniel Powter
Bad Day [VIDEO]	Daniel Powter
Anything But Love	Daniel Schumacher
Nothing's Gonna Stop Me Now	Daniela Katzenberger
Gino e l'Alfetta	Daniele Silvestri
NyaNyaNyaNyaNyaNyaNya	DaniwellP feat. Hatsune Miku
I Begin To Wonder	Dannii Minogue
Mother	Danzig
Desire	Darin
Insanity	Darin
Money For Nothing	Darin
One Summer	Daryl Braithwaite
Ich Wäre Gern Wie Du	Das Dschungelbuch
Probiers Mal Mit Gemütlichkeit	Das Dschungelbuch
Computerliebe	Das Modul
Absolute beginners	David Bowie
Ashes To Ashes	David Bowie
Changes	David Bowie
Let's Dance	David Bowie
Life On Mars  [VIDEO]	David Bowie
Life On Mars?	David Bowie
Space Oddity	David Bowie
Dancing In The Street	David Bowie & Mick Jagger
Dos hombres y un destino	David Bustamante & Alex Ubago
Bye Bye	David Civera
Jeans On	David Dundas
She Wolf (Falling To Pieces)	David Guetta & Sia
Turn Me On	David Guetta feat. Nicki Minaj
Titanium	David Guetta feat. Sia
Without You	David Guetta feat. Usher
Where Them Girls At	David Guetta ft. Flo Rida & Nicki Minaj
Crazy For You	David Hasselhoff
Do the Limbo Dance	David Hasselhoff
Jump In My Car	David Hasselhoff
Looking for Freedom	David Hasselhoff
Wir Zwei allein (Duett)	David Hasselhoff & Gwen
Just A Gigolo - Ain't Got Nobody	David Lee Roth
Just A Gigolo - I Ain't Got Nobody	David Lee Roth
Scooby Doo Theme Song	David Mook
Wild At Heart	David Pedersen
Put A Little Love In Your Heart	David Ruffin
Rimmel	De Gregori
Lebt Denn Dr Alte Holzmichl Noch	De Randfichten
I 18	Dead Smiling Pirates
You Spin Me Round (Like A Record	Dead or Alive
You Spin Me Round (Like A Record)	Dead or Alive
Buona sera	Dean Martin
Groove is in the Heart	Deee-lite
Groove is in the Heart (Karaoke)	Deee-lite
Breakfast At Tiffany's [VIDEO]	Deep Blue Something
Fireball	Deep Purple
Smoke On The Water	Deep Purple
Diamond Eyes	Deftones
Luftbahn	Deichkind
Remmi Demmi (Yippie Yippie Yeah) [VIDEO]	Deichkind
Du Wichser	Deliah
This Is Me	Demi Lavato & Joe Jonas
Enjoy The Silence	Depeche Mode
People Are People	Depeche Mode
Photographic	Depeche Mode
Policy Of Truth	Depeche Mode
Hakuna Matata	Der König Der Löwen
Voyage Voyage	Desireless
Bootylicious [VIDEO]	Destiny's Child
Say My Name	Destiny's Child
Survivor	Destiny's Child
Das W auf dem Trikot	Deutschmacher
Come On Eileen	Dexy's Midnight Runners
Come On Eileen [VIDEO]	Dexy's Midnight Runners
Vem Ska Jag Tro På?	Di Leva
I'm Coming Out	Diana Ross
My endless Love	Diana Ross & Lionel Richie
Reflections	Diana Ross & The Supremes
Baby Love [VIDEO]	Diana Ross And The Supremes
Mamma Maria	Diana Sorbello
Coming Home	Diddy Dirty Money ft. Skylar Grey
Hunter	Dido
Life for rent [VIDEO]	Dido
Sand in my shoes	Dido
Thank You	Dido
Thank You (Karaoke)	Dido
Thank You [VIDEO]	Dido
White Flag	Dido
White Flag (Karaoke) [VIDEO]	Dido
White Flag [VIDEO]	Dido
Die Boten	Die Apokalyptischen Reiter
Die Sonne Scheint	Die Apokalyptischen Reiter
Friede sei mit dir	Die Apokalyptischen Reiter
Mief	Die Doofen
Mief (Nimm Mich Jetzt, Auch Wenn Ich Stinke)	Die Doofen
Und Tschüss	Die Familie
Die Da?! (Smudo)	Die Fantastischen Vier
Die Da?! (Thomas)	Die Fantastischen Vier
Geboren	Die Fantastischen Vier
Sie Ist Weg	Die Fantastischen Vier
Aber Dich Gibts Nur Einmal Für Mich	Die Flippers
Das Schlimmste Ist, Wenn Das Bier Alle Ist	Die Kassierer
Alle meine Entchen	Die Lollipops
Die Lollipops-Alle meine Entchen	Die Lollipops
Alles Nur Geklaut	Die Prinzen
Du musst ein Schwein sein	Die Prinzen
Mein Fahrrad	Die Prinzen
Millionär	Die Prinzen
Auld Lang Syne [VIDEO]	Die Roten Rosen
Happy X-Mas	Die Roten Rosen
Leise rieselt der Schnee	Die Roten Rosen
Still, Still, Still	Die Roten Rosen
Stille Nacht	Die Roten Rosen
White Christmas	Die Roten Rosen
Lass uns schmutzig Liebe machen	Die Schröders
Die Schöne Und Das Biest	Die Schöne Und Das Biest
1000 Gute GrÃ¼nde	Die Toten Hosen
1000 Gute Gründe	Die Toten Hosen
All Die Ganzen Jahre	Die Toten Hosen
All die ganzen Jahre	Die Toten Hosen
Alles Aus Liebe	Die Toten Hosen
Alles Was War	Die Toten Hosen
Alles Wird Vorübergehen	Die Toten Hosen
Auld Lang Syne	Die Toten Hosen
Bayern	Die Toten Hosen
Bis zum bitteren Ende	Die Toten Hosen
Bonnie & Clyde	Die Toten Hosen
Bonnie And Clyde	Die Toten Hosen
Eisgekühlter Bommerlunder	Die Toten Hosen
Freunde	Die Toten Hosen
Friss Oder Stirb	Die Toten Hosen
Hier Kommt Alex	Die Toten Hosen
Hier Kommt Alex (Unplugged)	Die Toten Hosen
Hier kommt Alex [VIDEO]	Die Toten Hosen
Ich bin die Sehnsucht in dir	Die Toten Hosen
Kein Alkohol	Die Toten Hosen
Nur Zu Besuch	Die Toten Hosen
Paradies	Die Toten Hosen
Pushed Again	Die Toten Hosen
Schön Sein	Die Toten Hosen
Schönen Gruß, auf Wiederseh'n	Die Toten Hosen
Steh Auf, Wenn Du Am Boden Bist	Die Toten Hosen
Still, Still, Still	Die Toten Hosen
Strom	Die Toten Hosen
Tage wie diese	Die Toten Hosen
Unsterblich	Die Toten Hosen
Walkampf	Die Toten Hosen
Warum Werde Ich Nicht Satt [VIDEO]	Die Toten Hosen
Was Zählt	Die Toten Hosen
Wünsch Dir Was	Die Toten Hosen
Zehn Kleine Jägermeister	Die Toten Hosen
1-2 Lovesong [VIDEO]	Die Ärzte
3 Tage Bart	Die Ärzte
Anders als beim letzten Mal	Die Ärzte
Bitte Bitte...	Die Ärzte
Claudia hat 'nen Schäferhund	Die Ärzte
Deine Schuld	Die Ärzte
Der Graf	Die Ärzte
Die Welt ist schlecht	Die Ärzte
Die Ärzte - Die Ärzte - Rebell	Die Ärzte
Ein Sommer nur für mich	Die Ärzte
Ein Song namens Schunder	Die Ärzte
El Cattivo	Die Ärzte
Elke	Die Ärzte
Fette Elke	Die Ärzte
Für Uns	Die Ärzte
Geisterhaus (Live)	Die Ärzte
Geschwisterliebe	Die Ärzte
Grace Kelly	Die Ärzte
Hurra	Die Ärzte
Ich weiß nicht ob es Liebe ist	Die Ärzte
Ignorama	Die Ärzte
Ist das noch Punkrock	Die Ärzte
Junge	Die Ärzte
Komm zurück	Die Ärzte
Lasse redn [VIDEO]	Die Ärzte
Lied vom Scheitern [VIDEO]	Die Ärzte
Living Hell	Die Ärzte
Mach die Augen zu	Die Ärzte
Manchmal haben Frauen [VIDEO]	Die Ärzte
Meine Freunde	Die Ärzte
Mysteryland	Die Ärzte
Männer Sind Schweine [VIDEO]	Die Ärzte
N 48.3	Die Ärzte
Nicht Allein	Die Ärzte
Nichts in der Welt [VIDEO]	Die Ärzte
Nie Wieder Krieg, Nie Mehr Las Vegas	Die Ärzte
Nie gesagt	Die Ärzte
Nur einen Kuss	Die Ärzte
Ohne dich	Die Ärzte
Omaboy	Die Ärzte
Popstar	Die Ärzte
Quark	Die Ärzte
Radio brennt	Die Ärzte
Radio brennt (Deja Vu-Version)	Die Ärzte
Revolution - Kopfüber in die Hölle	Die Ärzte
Rock Rendezvous	Die Ärzte
Saufen	Die Ärzte
Schlaflied	Die Ärzte
Schrei nach Liebe (Unplugged) [VIDEO]	Die Ärzte
Schrei nach Liebe [VIDEO]	Die Ärzte
Schundersong [VIDEO]	Die Ärzte
Super Drei	Die Ärzte
Sweet Sweet Gwendoline	Die Ärzte
Teenagerliebe	Die Ärzte
Unrockbar [VIDEO]	Die Ärzte
Westerland [VIDEO]	Die Ärzte
Wie am ersten Tag	Die Ärzte
Wie ein Kind	Die Ärzte
Wie es geht	Die Ärzte
Yoko Ono [VIDEO]	Die Ärzte
Zu Spät	Die Ärzte
Zu spät (Satanische-Pferde-Live-Version)	Die Ärzte
Erna Kommt	Dieter De
Es War Sommer (Die Wahre Geschichte)	Dieter Thomas Kuhn
Tanze Samba mit mir	Dieter Thomas Kuhn
Und es war Sommer	Dieter Thomas Kuhn
Und es war Sommer [VIDEO]	Dieter Thomas Kuhn
Wann wird´s mal wieder richtig Sommer?	Dieter Thomas Kuhn
Über den Wolken	Dieter Thomas Kuhn
Wenn das Feuer in dir brennt	Digimon
The Wanderer	Dion
That's what friends are for	Dionne Warwick
Brothers In Arms	Dire Straits
Sultans of Swing [VIDEO]	Dire Straits
I'Ve Had The Time Of My Life	Dirty Dancing
Bang Bang You're Dead	Dirty Pretty Things
Bang Bang You're Dead [VIDEO]	Dirty Pretty Things
Chip & Chap Theme	Disney
Darkwing Duck Theme	Disney
Gummibären	Disney
Gummibärenbande Theme	Disney
Gummi Bears	Disney The Brown Derbies
Küss Sie Doch [VIDEO]	Disney's Arielle
Unter dem Meer	Disney's Arielle
Darkwing Duck Theme	Disney's Darkwing Duck
Die Schöne und das Biest	Disney's Die Schöne und das Biest
Theme	Disney's Duck Tales
I'll Make A Man Out Of You	Disney's Mulan
I Wanna Be Like You (Duett)	Disney's The Jungle Book
Wir Sind Eins	Disneys König der Löwen 2
Farbenspiel des Winds	Disneys Pocahontas
We Are One	Disneys The Lion King
Spiegelbild	DisneyÂ´s Mulan
Another Way To Die	Disturbed
Asylum	Disturbed
Believe	Disturbed
Darkness	Disturbed
Down With The Sickness	Disturbed
Indestructible	Disturbed
Inside The Fire	Disturbed
Land of Confusion	Disturbed
Prayer	Disturbed
Remember	Disturbed
Shout 2000	Disturbed
Shout 2000 [Karaoke]	Disturbed
Stricken	Disturbed
Stupify	Disturbed
Stupify (Karaoke)	Disturbed
The Night	Disturbed
Voices	Disturbed
I Touch Myself	Divinyls
Not Ready To Make Nice	Dixie Chicks
Noch In 1000,000 Jahren	Dj Otzi
Good Enough	Dodgy
Eine Insel mit zwei Bergen	Dolls United
9 To 5	Dolly Parton
I will always love you	Dolly Parton
Jolene	Dolly Parton
Oberaffengeil	Domstürmer
Riidankylväjä	Don Huonot
Danza Kuduro	Don Omar ft. Lucenzo
Some Broken Hearts Never Mend	Don Williams
She Works Hard For The Money	Donna Summer
She Works Hard For The Money [VIDEO]	Donna Summer
Whatever Will Be Wil Be	Doris Day
Traum-Walzer	Dornroschen
Warum Nur	Dornroschen
Calcutta (Taxi, Taxi, Taxi)	Dr. Bombay
Marmor, Stein und Eisen bricht	Drafi Deutscher
Dan Dan Kokoro Hikareteku	Dragon Ball GT
Du wirst unbesiegbar sein	Dragonball Z
Chala Head Chala	DragonballZ
Cry of the Brave	Dragonforce
My Spitit will go on	Dragonforce
Valley of the Damned	Dragonfroce
01 - Regression	Dream Theater
Bug Eyes	Dredg
Catch Without Arms	Dredg
Hung Over on a Tuesday	Dredg
Matroshka	Dredg
Planting Seeds	Dredg
Sang Real	Dredg
Spitshine	Dredg
Dirty Glass	Dropkick Murphys
I'm Shipping Up To Boston	Dropkick Murphys
Johnny I Hardly Knew Ya	Dropkick Murphys
DschinghisKahn	Dschinghis Kahn
Moskau	Dschinghis Khan
Flow	Dub Fx
Theme	Duck Tales
Mercy	Duffy
Warwick Avenue	Duffy
En Algún Lugar	Duncan Dhu
Hungry Like The Wolf	Duran Duran
Ordinary World	Duran Duran
Rio	Duran Duran
Son Of A Preacher Man	Dusty Springfield
Son of a Preacher Man	Dusty Springfield
300 PS	EAV
Burli	EAV
Ding Dong	EAV
Drei ausgeflippte Pinguine	EAV
Drei verliebte Pinguine (Teil 1)	EAV
Drei verliebte Pinguine (Teil 2)	EAV
Drei weiße Tauben	EAV
Drei zersiebte Pinguine	EAV
Flugzeug (Liebste Mein)	EAV
God Bless America	EAV
Jambo	EAV
Morgen	EAV
Märchenprinz	EAV
Neue Helden (braucht das Land)	EAV
Nie wieder Kunst (wie immer...)	EAV
Wie Eine Fatamorgana	EAV
Wo ist der Kaiser	EAV
Unbelievable	EMF
Save Tonight [VIDEO]	Eagle Eye Cherry
September '99 (Phats & Small Remix)	Earth Wind & Fire
The Killing Moon	Echo & The Bunnymen
Du Trägst Keine Liebe In Dir	Echt
Fort Von Mir	Echt
Junimond	Echt
Weinst Du	Echt
Gimme Hope Jo´anna	Eddy Grant
King Of Fools	Edguy
Superheroes	Edguy
Il gatto e la volpe	Edoardo Bennato
Trololo	Eduard Khil
War [VIDEO]	Edwin Starr
A Girl Like You	Edwyn Collins
Blue	Eiffel 65
I'm Not Scared	Eighth Wonder
Eisblumen	Eisblume
17 Kerzen am Dom	Eisregen
Bei den Gräbern	Eisregen
Das kleine Leben	Eisregen
Fleischhaus	Eisregen
Futter für die Schweine	Eisregen
Krebskolonie	Eisregen
Lili Marleen	Eisregen
Meine tote russische Freundin	Eisregen
Pest 1 (4) ... und über allem weht der Wind so kalt	Eisregen
Wundwasser	Eisregen
Legende des Leides	Eisregen - Pest 2 (4)
In der Grube	Eisregen - Pest 3 (4)
Auferstehung	Eisregen - Pest 4 (4)
Fossi Figo	Elio E Le Storie Tese
John Holmes (Una Vita Per Il Cinema)	Elio E Le Storie Tese
Eppure sentire	Elisa
Running Scared	Ell & Nikki
Küss mich, halt mich, lieb mich	Ella Endlich
Let's Call The Whole Thing Off	Ella Fitzgerald and Louis Armstrong
Let's Call The Whole Thing Off (Ella)	Ella Fitzgerald and Louis Armstrong
Let's Call The Whole Thing Off (Louis)	Ella Fitzgerald and Louis Armstrong
Can You Feel The Love Tonight	Elton John
Can You Feel The Love Tonight [VIDEO]	Elton John
Candle In The Wind (Goodbye England's Rose)	Elton John
Crocodile Rock	Elton John
Goodbye Yellow Brick Road	Elton John
I'm Still Standing	Elton John
I'm Still Standing [VIDEO]	Elton John
Nikita [VIDEO]	Elton John
Rocket Man	Elton John
Rocket Man [VIDEO]	Elton John
Sacrifice [VIDEO]	Elton John
Skyline Pigeon	Elton John
Sorry Seems To Be The Hardest Word	Elton John
Your Song	Elton John
Don't Let The Sun Go Down On Me	Elton John & George Michael
Don't Go Breaking My Heart	Elton John & Kiki Dee
Don't Go Breaking My Heart [VIDEO]	Elton John & Kiki Dee
A Little Less Conversation (JXL Remix)	Elvis Presley
Are You Lonesome Tonight	Elvis Presley
Blue Suede Shoes	Elvis Presley
Blue Suede Shoes [VIDEO]	Elvis Presley
Can't Help Falling In Love	Elvis Presley
Crying In The Chapel	Elvis Presley
Don't Be Cruel	Elvis Presley
Don't Cry Daddy	Elvis Presley
Fever	Elvis Presley
Flaming Star	Elvis Presley
His Latest Flame	Elvis Presley
In The Ghetto	Elvis Presley
Its now or never	Elvis Presley
Kiss Me Quick	Elvis Presley
Love Me Tender	Elvis Presley
O Danny Boy	Elvis Presley
Return to sender	Elvis Presley
Snowbird	Elvis Presley
Suspicious minds	Elvis Presley
Suspicious minds (Karaoke)	Elvis Presley
Suspicious minds (Karaoke) [VIDEO]	Elvis Presley
Suspicious minds [VIDEO]	Elvis Presley
Teddybear	Elvis Presley
The Girl Of My Best Friend	Elvis Presley
The Wonder Of You	Elvis Presley
Viva las Vegas	Elvis Presley
Way Down	Elvis Presley
Way Down [VIDEO]	Elvis Presley
Welcome To My World	Elvis Presley
Wooden Heart	Elvis Presley
You were always on my mind	Elvis Presley
Wooden Heart	Elvis Presly
Big Big World	Emilia
Gollum's Song	Emiliana Torrini
Mockingbird	Eminem
Not Afraid	Eminem
When I´m Gone	Eminem
Stan	Eminem feat. Dido
Love The Way You Lie	Eminem ft. Rihanna
Tu Seras	Emma Daumas
We Are The People	Empire Of The Sun
Free Your Mind	En Vogue
My Lovin' (You're Never Gonna Get It)	En Vogue
Lisa	Endstufe
Return to Innocence	Enigma
Do You Know	Enrique Iglesias
Hero	Enrique Iglesias
Takin' Back My Love	Enrique Iglesias feat. Ciara
Takin´ Back My Love	Enrique Iglesias feat. Ciara
I Like It	Enrique Iglesias ft. Pitbull
Losing The Ground	Entwine
May It Be	Enya
Tahroja Paperilla	Eppu Normaali
A Little Respect	Erasure
Always	Erasure
Paid In Full	Eric B And Rakim
Cocaine	Eric Clapton
I Shot The Sheriff	Eric Clapton
Layla (Unplugged) [VIDEO]	Eric Clapton
My Father's Eyes	Eric Clapton
Tears in Heaven (unplugged) [VIDEO]	Eric Clapton
Wer hat an der Uhr gedreht	Eric Frantzen Orchester
Se Bastasse Una Bella Canzone	Eros Ramazotti
Cosa della vita	Eros Ramazzotti
Un emozione per sempre	Eros Ramazzotti
Amarti è l'immenso per me	Eros Ramazzotti & Antonella Bucci
Non Siamo Soli	Eros Ramazzotti & Ricky Martin
Carrie	Europe
Final Countdown	Europe
I Saved The World Today	Eurythmics
Sweet Dreams	Eurythmics
Sweet Dreams (Steve Angello Remix)	Eurythmics
Silly Boy	Eva Simons
Bring Me To Life	Evanescence
Bring me to life [VIDEO]	Evanescence
Call Me When Your Sober [VIDEO]	Evanescence
Everybody's Fool [VIDEO]	Evanescence
Going under [VIDEO]	Evanescence
Hello	Evanescence
I Must be dreaming	Evanescence
Lithium [VIDEO]	Evanescence
My Immortal [VIDEO]	Evanescence
My Last Breath [VIDEO]	Evanescence
October	Evanescence
So Close	Evanescence
Tourniquet	Evanescence
Light Surrounding You	Evermore
Your Song	Ewan McGregor
Wann spielt ihr endlich wieder Grindcore?	Excrementory Grindfuckers
Flieger, Grüss Mir Die Sonne	Extrabreit
More Than Words [VIDEO]	Extreme
Lydia	F.I.R
Wo men de ai [VIDEO]	F.I.R
Words	F.R. David
Blau und Weiss	FC Schalke 04
In Italia ft Gianna Nannini	Fabri Fibra & Gianna Nannini
Il pescatore	Fabrizio De André
Efter Plugget	Factory
Zhi dui ni you gan jue	Fahrenheit & Hebe Tian
Perfect	Fairground Attraction
Red Umbrella	Faith Hill
Digging The Grave	Faith No More
Easy	Faith No More
Falling To Pieces	Faith No More
From out of Nowhere	Faith No More
Midlife Crisis	Faith No More
Ricochet	Faith No More
Der Kommissar	Falco
Egoist (Remix Version)	Falco
Mutter der Mann mit dem Koks ist da	Falco
Out of the Dark	Falco
Rock Me Amadeus	Falco
Vienna Calling	Falco
Dance Dance	Fall Out Boy
Dance Dance [VIDEO]	Fall Out Boy
This Ain't A Scene	Fall Out Boy
Thnks Fr Th Mmrs	Fall Out Boy
Beat it	Fall Out Boy ft. John Mayer
Give Me Your Love	Fame
Theme	Family Guy
Retorciendo Palabras	Fangoria
MFG	Fantastischen 4
Alle dasselbe	Farin Urlaub
Dusche	Farin Urlaub
Glücklich [VIDEO]	Farin Urlaub
Immer noch	Farin Urlaub
Petze	Farin Urlaub
Phaenomenal Egal [VIDEO]	Farin Urlaub
Porzellan	Farin Urlaub
Sonne	Farin Urlaub
Unter Wasser	Farin Urlaub
Wo ist das Problem	Farin Urlaub
Praise you	Fatboy Slim
Eyes on Me	Faye Wong
Big Girls Don't Cry	Fergie
Big girls don't cry [VIDEO]	Fergie
Clumsy [VIDEO]	Fergie
Ein Geheimnis	Fertig, Los!
Emanuela	Fettes Brot
Schwule Mädchen (Duett)	Fettes Brot
Bettina zieh dir bitte etwas an	Fettes Brot mit Modeselektor
She Drives Me Crazy	Fine Young Cannibals
Paralyzer	Finger Eleven
Diventerai Una Star	Finley
C'est la vie	Fish Leong
System Addict	Five Star
System Addict [VIDEO]	Five Star
Go Your Own Way	Fleetwood Mac
Little Lies	Fleetwood Mac
Good Feeling	Flo Rida
Right Round	Flo Rida
Whistle	Flo Rida
Wild Ones	Flo Rida feat. Sia
Low	Flo Rida feat. T-Pain
Drunken Lullabies	Flogging Molly
Requiem for A Dying Song	Flogging Molly
You've Got The Love	Florence & The Machines
Ma liberté de penser	Florent Pagny
Only You	Flying Pickets
Best Of You	Foo Fighters
Everlong	Foo Fighters
My Hero	Foo Fighters
The Pretender	Foo Fighters
Lemon Tree	Fool's Garden
I Want To Know What Love Is	Foreigner
Pumped Up Kicks	Foster The People
Stacy's Mom	Fountains Of Wayne
I Can't Help Myself	Four Tops
Uno más uno son siete	Fran Perea
Ein bißchen Goethe, ein bißchen Bonaparte	France Gall
Raccontami	Francesco Renga
Cuccurucucu	Franco Battiato
Hip Teens (Don't Wear Blue Jeans)	Frank Pop Esemble
My Way	Frank Sinatra
New York, New York	Frank Sinatra
Santa Claus Is Coming To Town	Frank Sinatra
Strangers In The Night	Frank Sinatra
Hier kommt Kurt	Frank Zander
Oh Susi	Frank Zander
Ferry Cross The Mersey	Frankie Goes To Hollywood
The Power Of Love	Frankie Goes To Hollywood
The Power Of Love [VIDEO]	Frankie Goes To Hollywood
Do You Want To	Franz Ferdinand
Do You Want To [VIDEO]	Franz Ferdinand
Take Me Out	Franz Ferdinand
Ulysses	Franz Ferdinand
Schau Mir Ins Gesicht	Franziska
Das Geht Ab	Frauenarzt & Manny Marc
Disco Pogo	Frauenarzt & Manny Marc
Florida Lady	Frauenarzt & Manny Marc Feat Andreas Martin
I sing in the Rain	Fred Astaire
Living On My Own [VIDEO]	Freddie Mercury
The Great Pretender	Freddie Mercury
All Right Now	Free
Alright Now	Free
Farewell	Freedom Call
Fantasi	Freestyle
Weil du mich nur verarscht hast	Frei.Wild
Mit Dir	Freundeskreis
Listen To Your Heartbeat	Friends
Genie Auf Die Ski	Fritz & The Downhill Gang
Killing me softly	Fugees
Saufen, Fressen und F.....	Funny van Dannen
Dead + Gone	Fury In The Slaughterhouse
Dein Herz Schlägt Schneller	Fünf Sterne deluxe
Sweet About Me [VIDEO]	Gabriella Cilmi
Freed From Desire	Gala
Abyss Of The Void	Gamma Ray
Abyss Of The Void (karaoke)	Gamma Ray
I Think I'm Paranoid	Garbage
Push It	Garbage
The world is not enough	Garbage
The River	Garth Brooks
Unanswered Prayers	Garth Brooks
I Like Chopin	Gazebo
Kreuzberger Nachte	Gebruder Blattschuss
Bruttosozialprodukt	Geier Sturzflug
Holly E Benji	GemBoy
Dammi solo un minuto	Gemelli Diversi
Follow You, Follow Me	Genesis
I can't dance	Genesis
Jesus he knows me	Genesis
Mama	Genesis
Careless Whisper	George Michael
Careless Whisper (Karaoke)	George Michael
Careless Whisper (Karaoke) [VIDEO]	George Michael
Careless Whisper [VIDEO]	George Michael
Faith	George Michael
Faith (Karaoke) [VIDEO]	George Michael
Faith [VIDEO]	George Michael
One More Try	George Michael
Sag ihr auch	Gerd Christian
It's raining men [VIDEO]	Geri Halliwell
Baker Street	Gerry Rafferty
Cammina nel sole	Gianluca Grignani
Destinazione Paradiso	Gianluca Grignani
La mia storia fra le dita	Gianluca Grignani
I will fly with you	Gigi D'agustino
L'Amore Che Non C'è	Gigi d'Alessio
Hey Jealousy	Gin Blossoms
Colpo di fulmine	Gin Di Tonno & Lola Ponce
Di sole e d'azzurro	Giorgia
Girasole	Giorgia
Tutti all'arrembaggio	Giorgio Vanni & Cristina d'Avena
Biology	Girls Aloud
Call The Shots	Girls Aloud
No Good Advice	Girls Aloud
Ich will nen Cowboy als Mann	Gitte
So Schön Kann Doch Kein Mann Sein	Gitte
Heidi	Gitti & Erica
Non ti scordar mai di me	Giusy Ferreri
Haltet Die Welt An	Glashaus
Gangnam Style	Glee
Glad You Came	Glee
Starships	Glee
Survivor, I Will Survive	Glee
We Are Young	Glee
What Makes You Beautiful	Glee
Don't Stop Believin'	Glee Cast
Somewhere over the Rainbow	Glee Cast
What Doesn't Kill You (Stronger)	Glee Cast
Hoy	Gloria Estefan
I Am What I Am	Gloria Gaynor
I Will Survive	Gloria Gaynor
Dancing Queen	Glow
Crazy [VIDEO]	Gnarls Barkley
Radar Love	Golden Earring
Ooh La La	Goldfrapp
Goo Goo Dolls - Iris	Goo Goo Dolls
Girls & Boys	Good Charlotte
Girls And Boys	Good Charlotte
Girls And Boys (Karaoke)	Good Charlotte
I Just Wanna Live	Good Charlotte
Predictable	Good Charlotte
The Anthem [VIDEO]	Good Charlotte
The River	Good Charlotte feat. M. Shadows
Clint Eastwood [VIDEO]	Gorillaz
Feel Good INC [VIDEO]	Gorillaz
Pozwol Zyc	Gosia Andrzejewicz
S³owa	Gosia Andrzejewicz
Heavy Cross	Gossip
Move in the right direction	Gossip
Perfect World	Gossip
Somebody That I Used To Know	Gotye feat. Kimbra
O Du Fröhliche	Graham Bonney
Heavy Metal breakdown	Grave Digger
Sandy	Grease
Summer Nights	Grease
You're the One that I Want [VIDEO]	Grease
Your the One that I Want	Grease
American Idiot [VIDEO]	Green Day
Are We the Waiting	Green Day
Basket Case	Green Day
Boulevard Of Broken Dreams	Green Day
Brain Stew	Green Day
East Jesus Nowhere	Green Day
Extraordinary Girl	Green Day
Geek Stink Breath	Green Day
Good Riddance (Time of my Life)	Green Day
Having A Blast	Green Day
Hitchin A Ride	Green Day
Holiday	Green Day
Jesus Of Suburbia	Green Day
King for a day	Green Day
Minority	Green Day
Oh Love	Green Day
Peacemaker	Green Day
The Static Age	Green Day
Wake me up when september ends	Green Day
When I Come Around	Green Day
Redneck Woman	Gretchen Wilson
Last Unicorn	Groove Coverage
Moonlight Shadow	Groove Coverage
Poison [VIDEO]	Groove Coverage
Runaway [VIDEO]	Groove Coverage
She	Groove Coverage
Big in Japan	Guano Apes
You Can't Stop Me	Guano Apes
Noche En Vela	Guaraná
canzone per una amica	Guccini e i Nomadi
Guildo Hat Euch Lieb	Guildo Horn & Die Orthopädischen Strümpfe
3rd Opening Theme	Gundam Seed Destiny
Civil war	Guns N Roses
Cats in the Cradle	Guns N' Roses
Don´t Cry	Guns N' Roses
It´s so easy	Guns N' Roses
Knocking On Heavens Door	Guns N' Roses
Live and let die	Guns N' Roses
Mr. Brownstone	Guns N' Roses
November Rain	Guns N' Roses
November Rain [VIDEO]	Guns N' Roses
Paradise City	Guns N' Roses
Paradise City [VIDEO]	Guns N' Roses
Sweet child o´Mine [VIDEO]	Guns N' Roses
Welcome to the jungle	Guns N' Roses
Infinity 2008	Guru Josh Project
Da Sprach Der Alte Hauptling Der Indianer	Gus Backus
Sauerkraut-Polka	Gus Backus
Cool	Gwen Stefani
Hollaback Girl [VIDEO]	Gwen Stefani
The Sweet Escape [VIDEO]	Gwen Stefani
What You Waiting For?	Gwen Stefani
The Sweet Escape	Gwen Stefani Feat Akon
Countdown To Insanity	H-Blockx
Ichirin no hana	HIGH and MIGHTY COLOR
The Funeral Of Hearts	HIM
SEASON'S CALL	HYDE
What Is Love	Haddaway
Die Ersten	Halogenpoeten
At The End Of The Rainbow	HammerFall
Crimson Thunder	HammerFall
Blood Bound	Hammerfall
Hearts On Fire	Hammerfall
Renegade	Hammerfall
The Fire Burns Forever	Hammerfall
I've Got Nerve	Hannah Montana
MMMBop	Hanson
Hard To Beat	Hard Fi
Moviestar	Harpo
Banana Boat	Harry Belafonte
Island In The Sun	Harry Belafonte
Das Lied der Deutschen	Haydn feat. Fallersleben
Alone	Heart
O Tannenbaum	Heintje
My Number One	Helena Paparizou
Ich will immer wieder (Dieses Fieber spür´n)	Helene Fischer
Katzeklo	Helge Schneider
Käsebrot	Helge Schneider
Dr. Stein	Helloween
Future World	Helloween
I'm Alive	Helloween
Unsung	Helmet
Im Wagen Von Mir	Henry Valentino Und Uschi
Demo (letzter Tag)	Herbert Grönemeyer
Der Weg [VIDEO]	Herbert Grönemeyer
Halt Mich	Herbert Grönemeyer
Mensch [VIDEO]	Herbert Grönemeyer
Männer	Herbert Grönemeyer
Country Roads	Hermes House Band
I Will Survive	Hermes House Band
Those Were The Days (J and R)	Hermes House Band
Those Were The Days (Sally)	Hermes House Band
Theme	Hero Turtles
Diggi-Loo Diggi-Ley	Herreys
Breaking Free (Duett)	High School Musical
Start of Something New [VIDEO]	High School Musical
Come clean	Hilary Duff
Wake Up	Hilary Duff
Join me	Him
Celebrity Skin	Hole
Words dont come easy	Hollies
Kiss Kiss [VIDEO]	Holly Valance
Lo Noto	Hombres G
The Reason	Hoobastank
Deine Spuren im Sand	Howard Carpendale
Hello Again	Howard Carpendale
Ti amo	Howard Carpendale
Tur An Tur Mit Alice	Howard Carpendale
Sternenhimmel	Hubert Kah
Brenna Tuats Guat	Hubert Von Goisern
PoP! Goes My Heart	Hugh Grant
Jungen Mädchen	Hund Am Strand
Hey Kölle!	Höhner
Schenk Mir Dein Herz	Höhner
Schenk mir dein Herz	Höhner
Viva Colonia	Höhner
Viva Colonia (Da Simmer Dabei, Dat Is Prima!)	Höhner
Wenn Nicht Jetzt, Wann Dann (Weltmeister Version)	Höhner
Der Knutschfleck	IXI
Umarme Mich	Ich
Du Erinnerst Mich An Liebe [VIDEO]	Ich & Ich
So soll es bleiben	Ich + Ich
Stark [VIDEO]	Ich + Ich
Umarme Mich	Ich + Ich
Geranium	Ich Troje
Wypijmy Za To	Ich Troje
Vom Selben Stern	Ich Und Ich
Vom Selben Stern [VIDEO]	Ich&Ich
I Love It	Icona Pop
Real Wild Child (Wild One)	Iggy Pop
Real Wild One	Iggy Pop
Blue bird	Ikimono gakari
Küss Mich	In Extremo
Cloud connected	In Flames
Metaphor	In Flames
Ikuinen Virta	Indica
Sweat (A la la la la long)	Inner Circle
Good Life	Inner City
Be Quick or Be Dead	Iron Maiden
Fear Of The Dark	Iron Maiden
Hallowed Be Thy Name	Iron Maiden
Number of the beast	Iron Maiden
Rime of the Ancient Mariner	Iron Maiden
Run to the hills	Iron Maiden
The Trooper	Iron Maiden
Somewhere Over The Rainbow (Wonderful World)	Israel Kamakawiwo Ole
Il Re leone	Ivana Spagna
Doris	J Karjalainen Ja Mustat Lasit
Der Spatz in der Hand	J.B.O.
Ein guter Tag zum Sterben (terminale Version)	J.B.O.
Ejaculation Praecox	J.B.O.
Verteidiger Des Blödsinns	J.B.O.
Sitting, Waiting, Wishing	Jack Johnson
Upside Down	Jack Johnson
No Matter	Jack Radics
Reet Petite	Jackie Wilson
ABC (Jackson 5)	Jackson 5
ABC (Michael)	Jackson 5
Wen Bie [VIDEO]	Jacky Cheung
Fiumi di parole	Jalisse
Beware of the Dog	Jamelia
Stop	Jamelia
Stop [VIDEO]	Jamelia
Superstar	Jamelia
Superstar (Karaoke)	Jamelia
Superstar (Karaoke) [VIDEO]	Jamelia
Superstar [VIDEO]	Jamelia
Thank You [VIDEO]	Jamelia
1973 [VIDEO]	James Blunt
High	James Blunt
No bravery	James Blunt
Wise Men	James Blunt
Wise Men (Karaoke)	James Blunt
You're Beautiful [VIDEO]	James Blunt
I Feel Good	James Brown
Unbreakable	James Cottriall
You Give Me Something	James Morrison
You Give Me Something [VIDEO]	James Morrison
Broken Strings	James Morrison feat. Nelly Furtado
Alright	Jamiroquai
Cosmic Girl	Jamiroquai
Cosmic Girl [VIDEO]	Jamiroquai
Deeper Underground	Jamiroquai
Virtual Insanity	Jamiroquai
Für Immer Und Dich	Jan Delay
Klar	Jan Delay
Trendy Eistee	Jan Hegenberg
Se På Mig	Jan Johansen
Because the Night	Jan Wayne
Es war einmal im Dezember	Jana Werner
Växeln Hallå	Janne Lucas
Yin Yang	Jarabe de Palo
Whatcha Say	Jason DeRulo
In My Head	Jason Derulo
I'm Yours	Jason Mraz
Real Things	Javine
Bu Neng Shuo De Mi Mi [VIDEO]	Jay Chou
Cai Hong	Jay Chou
Ju hua tai [VIDEO]	Jay Chou
Niu zai hen mang [VIDEO]	Jay Chou
Pu Gong Ying De Yue Ding [VIDEO]	Jay Chou
Qing Hua Ci	Jay Chou
Qing Tian [VIDEO]	Jay Chou
Ting Ma Ma De Hua [VIDEO]	Jay Chou
San Hu Hai ( [VIDEO])	Jay Chou & Lara
San Hu Hai (Jay Chou)	Jay Chou & Lara
Empire state of mind	Jay-Z feat. Alicia Keys
Empire State Of Mind	Jay-Z ft. Alicia Keys
Young Forever	Jay-Z ft. Mr. Hudson
Ain't it funny	Jennifer Lopez
Jenny From The Block	Jennifer Lopez
Jenny From The Block [VIDEO]	Jennifer Lopez
Let's Get Loud	Jennifer Lopez
Goin' In	Jennifer Lopez & Flo Rida
I'm Into You	Jennifer Lopez ft. Lil Wayne
Beautiful Lie (Duett)	Jennifer Paige & Nick Carter
When The Rain Begins To Fall	Jermaine Jackson & Pia Zadora
Star Trek Deep Space Nine Main Theme (Season 4+)	Jerry Goldsmith
Star Trek Voyager Main Theme	Jerry Goldsmith
Leavin	Jesse McCartney
Right Where You Want Me	Jesse McCartney
How Will I Know	Jessica Folckner
Come On Over	Jessica Simpson
I Wanna Love You Forever	Jessica Simpson
With You	Jessica Simpson
Are You Gonna Be My Girl	Jet
Stronger Woman	Jewel
Crazy In Love	Jill Johnson
Pain	Jimmy Eat World
The Middle	Jimmy Eat World
What Becomes Of The Broken Hearted	Jimmy Ruffin
Leave (Get Out)	JoJo
Leave (Get Out) [VIDEO]	JoJo
Goldener Reiter	Joachim Witt
Drop The Pilot	Joan Armatrading
I love Rock´n Roll	Joan Jett
One Of Us	Joan Osborne
Summer In The City	Joe Cocker
Summer In The City [VIDEO]	Joe Cocker
Up Where We Belong	Joe Cocker & Jennifer Warnes
Das bisschen Haushalt	Johanna von Koczian
You're The Voice	John Farnham
Judy in disguise	John Fred & His Playboy Band
Happy Xmas	John Lennon
Imagine	John Lennon
Imagine [VIDEO]	John Lennon
Music	John Miles
A Boy Named Sue	Johnny Cash
Ghost Rider in the Sky	Johnny Cash
I Walk The Line	Johnny Cash
Ring Of Fire	Johnny Cash
Hai Dao (Pirate) [VIDEO]	Jolin
Ai Qing 36 Ji [VIDEO]	Jolin Tsai
Kuai You Ai [VIDEO]	Jolin Tsai
Rewind [VIDEO]	Jolin Tsai
This is Love [VIDEO]	Jolin Tsai
Just Another Day	Jon Secada
Just Another Day (Without You)	Jon Secada
S.O.S.	Jonas Brothers
A Talk with George	Jonathan Coulton
Better	Jonathan Coulton
Big Bad World One	Jonathan Coulton
Chiron Beta Prime	Jonathan Coulton
Code Monkey	Jonathan Coulton
Creepy Doll	Jonathan Coulton
Dance, Soterios Johnson, Dance	Jonathan Coulton
First of May	Jonathan Coulton
Flickr	Jonathan Coulton
Furry Old Lobster	Jonathan Coulton
I Crush Everything	Jonathan Coulton
I Feel Fantastic	Jonathan Coulton
I'm Your Moon	Jonathan Coulton
Ikea	Jonathan Coulton
Monkey Shines	Jonathan Coulton
Mr. Fancy Pants	Jonathan Coulton
My Beige Bear	Jonathan Coulton
Not About You	Jonathan Coulton
Re: Your Brains	Jonathan Coulton
Shop Vac	Jonathan Coulton
Skullcrusher Mountain	Jonathan Coulton
Still Alive	Jonathan Coulton
That Spells DNA	Jonathan Coulton
The Future Soon	Jonathan Coulton
When You Go	Jonathan Coulton
Aldrig Ensam	Jonathan Johansson
No Air	Jordin Sparks feat. Chris Brown
Aléjate	Josh Groban
Another Try	Josh Turner
Jessie	Joshua Kadison
On the run	Joshua Morin
Super Duper Love (Are You Diggin' On Me?) Pt. 1	Joss Stone
Super Duper Love (Are You Diggin' On Me?) Pt. 1 [VIDEO]	Joss Stone
A Te	Jovanotti
Bella	Jovanotti
Gente della notte	Jovanotti
Serenata rap	Jovanotti
Was Auch Immer	Joy Denalane
A Dios Le Pido	Juanes
La Camisa Negra	Juanes
You've Got Another Thing Comin'	Judas Priest
Amazing Grace	Judy Collins
Angel Of The Morning	Juice Newton
Dieses Leben	Juli
Geile Zeit [VIDEO]	Juli
Perfekte Welle	Juli
Regen Und Meer	Juli
Warum	Juli
Wir Beide	Juli
Am Tag Als Conny Kramer Starb	Juliane Werding
Stimmen Im Wind	Juliane Werding
When you tell me	Julio Iglesias
In Der Winterzeit	Jumpy & Mungo Jerry
Down	Junior
Immer Wenn Ich Taurig Bin	Jurgen
Konig Von Mallorca	Jurgen Drews
Eine Neue Liebe Ist Wie Ein Neues Leben	Jurgen Marcus
Boyfriend	Justin Bieber
Cry Me A River	Justin Timberlake
Cry Me A River [VIDEO]	Justin Timberlake
Rock Your Body	Justin Timberlake
Summer Love [VIDEO]	Justin Timberlake
What goes around	Justin Timberlake
So Schön Ist Es Nur Beim Apres Ski	Jäger DJ Alex
Superhupen	Jörg Und Dragan
Ein Bett im Kornfeld	Jürgen Drews
Ich Bau Dir Ein Schloss	Jürgen Drews
Ich bau' dir ein Schloss	Jürgen Drews
Über uns ist nur der Himmel	Jürgen Drews
Klopapier	K.I.Z
Der Berg Ruft	K2
All my life	KC & JoJo
I Was Made For Loving You	KISS
I Was Made For Loving You (Karaoke)	KISS
Nothin' to lose	KISS
Black Horse And The Cherry Tree	KT Tunstall
Black Horse And The Cherry Tree [VIDEO]	KT Tunstall
Suddenly I See	KT Tunstall
I Predict A Riot	Kaiser Chiefs
Na Na Na Na Naa [VIDEO]	Kaiser Chiefs
Ruby (Karaoke) [VIDEO]	Kaiser Chiefs
Ruby [VIDEO]	Kaiser Chiefs
A Sailorman's Hymn	Kamelot
The Human Stain	Kamelot
Carry On Wayward Son	Kansas
Über Sieben Brücken Musst Du Gehn	Karat
Dangerous	Kardinal Offishall feat. Akon
Die Biene Maja	Karel Gott
Club Foot	Kasabian
Run The Show (ft. Shaka Dee)	Kat Deluna
Whine Up (ft. Elephant Man)	Kat Deluna
Running Up That Hill	Kate Bush
Don't Give Up	Kate Bush & Peter Gabriel
Don't Give Up (Duett)	Kate Bush & Peter Gabriel
Nine Million Bicycles [VIDEO]	Katie Melua
Walking On Sunshine	Katrina And The Waves
Walking On Sunshine [VIDEO]	Katrina And The Waves
Firework	Katy Perry
Hot N Cold	Katy Perry
I Kissed A Girl	Katy Perry
I Kissed A Girl [VIDEO]	Katy Perry
Thinking of You	Katy Perry
Waking Up In Vegas	Katy Perry
Blah Blah Blah	Ke$ha
Everybody's Changing	Keane
Everybody's Changing [VIDEO]	Keane
Somewhere Only We Know	Keane
Somwhere Only We Know [VIDEO]	Keane
Days Go By	Keith Urban
Trick Me	Kelis
Red High Heels	Kellie Pickler
Beautiful Disaster	Kelly Clarkson
Because of you [VIDEO]	Kelly Clarkson
Behind These Hazel Eyes [VIDEO]	Kelly Clarkson
Breakaway	Kelly Clarkson
Breakaway [VIDEO]	Kelly Clarkson
Low	Kelly Clarkson
Miss Independent	Kelly Clarkson
Mr. Know It All	Kelly Clarkson
Since U Been Gone	Kelly Clarkson
An Angel	Kelly Family
Fell In Love With An Alien	Kelly Family
I Can't Help Myself	Kelly Family
Roses of Red	Kelly Family
Big Star	Kenny Chesney
Footloose	Kenny Loggins
Lucille	Kenny Rogers
Tú volverás	Ketama
Let It Rock (Feat. Lil Wayne)	Kevin Rudolf
Erase Me	Kid Cudi ft. Kanye West
All Summer Long	Kid Rock
Born Free	Kid Rock
Bra Vibrationer	Kikki Danielsson
Vem È Dé Du Vill Ha	Kikki, Bettan och Lotta
Ich Kann Auch Ohne Dich	Killerpilze
Liebmichhassmich	Killerpilze
Bette Davis Eyes	Kim Carnes
Lara	Kim Frank
Cambodia	Kim Wilde
Kids In America	Kim Wilde
In The Air Tonight	Kine
Sex On Fire	Kings Of Leon
The Bucket	Kings Of Leon
Tom Dooley	Kingston Trio
Nothin' To Lose	Kiss
An Der Nordseeküste	Klaus & Klaus
An der Nordseeküste (Duett)	Klaus & Klaus
Da steht ein Pferd auf'm Flur	Klaus & Klaus
1000 Und 1 Nacht	Klaus Lage
Faust auf Faust	Klaus Lage
Jezu jak siê cieszê	Klaus Mitffoch
It's Not Over Yet	Klaxons
Anti Country Song	Kleines Arschloch
Femme Like You	Kmaro
Alter Mann	Knorkator
Freak on a Leash	KoRn
Here To Stay	KoRn
Kocham Ciê Jak Irlandiê	Kobranocka
Der Ewige Kreis (Backing)	Koenig Der Loewen
Der Ewige Kreis (Lead)	Koenig Der Loewen
Ich Will Jetzt Gleich Koenig Sein	Koenig Der Lowen
Platforms a Plenty!	Koji Kondo & Shinobu Tanaka
Alone I break	Korn
Did My Time	Korn
Got the life	Korn
Mädchen Mädchen	Krümel
Zieh Dich Aus Wir Müssen Reden	Krümel
PONPONPON	Kyary Pamyu Pamyu
Can't Get You Out Of My Head	Kylie Minogue
I Should Be So Lucky	Kylie Minogue
In Your Eyes	Kylie Minogue
Chaque Seconde	Kyo
Demon Cleaner	Kyuss
Der ewige Kreis	Köenig der Löwen
Ich will jetzt gleich König Sein	König der Löwen
Blurry Eyes	L'Arc~en~Ciel
Blurry Eyes (karaoke)	L'Arc~en~Ciel
Ready Steady Go	L'arc en Ciel
Une Etincelle	L5
Party Rock Anthem	LMFAO ft. Lauren Bennett & Goon Rock
20 De Enero	La Oreja de Van Gogh
Puedes Contar Conmigo	La Oreja de Van Gogh
Rosas	La oreja de Van Gogh
Jetzt Erst Recht	LaFee
Phantom Of The Opera	Lacrimosa
Enjoy The Silence	Lacuna Coil
He's A Tramp	Lady & The Tramp
Love Don't Live Here	Lady Antebellum
Alejandro (Don´t Call My Name)	Lady GaGa
Bad Romance	Lady GaGa
Beautiful dirty rich	Lady GaGa
Born This Way	Lady GaGa
Boys, boys, boys	Lady GaGa
Eh Eh (Nothing Else I Can Say)	Lady GaGa
Fashion	Lady GaGa
I like it rough	Lady GaGa
Lovegame	Lady GaGa
Paparazzi	Lady GaGa
Paper gangsta	Lady GaGa
Poker Face	Lady GaGa
Speechless	Lady GaGa
Summerboy	Lady GaGa
Teeth	Lady GaGa
The Fame	Lady GaGa
Telephone	Lady GaGa feat. Beyonce
Just Dance	Lady GaGa feat. Colby O´Donis
Christmas tree	Lady GaGa feat. Space Cowboy
Bad Romance	Lady Gaga
Dance In The Dark	Lady Gaga
Eh Eh (Nothing Else I Can Say)	Lady Gaga
Fashion	Lady Gaga
Love Game	Lady Gaga
Lovegame	Lady Gaga
Monster	Lady Gaga
Second Time around	Lady Gaga
So Happy I Could Die	Lady Gaga
Just Dance	Lady Gaga feat. Colby O'Donis
Kryzysowa Narzeczona	Lady Pank
Beweg dein Arsch	Lafee
Change Despair	Lagwagon
Sunshine Reggae	Laid Back
Leb Den Tag	Laith Al Deen
Alles An Dir	Laith Al-Deen
Bilder Von Dir	Laith Al-Deen
Video Games	Lana Del Rey
Scooby Doo, Where Are You [VIDEO]	Larry Marks
The ketchup song	Las Ketchup
Eres un enfermo	Las Supremas de Móstoles
É Dé Det Här Du Kallar Kärlek	Lasse Holm och Monica Törnell
Io non credo nei miracoli	Laura Bono
Self Control	Laura Branigan
Ascolta il tuo cuore	Laura Pausini
Destinazione Paradiso	Laura Pausini
Il mio sbaglio più grande	Laura Pausini
Incancellabile	Laura Pausini
Io Canto	Laura Pausini
Spaccacuore	Laura Pausini
Dare to live (Vivere)	Laura Pausini & Andrea Bocelli
Zombie on your Lawn	Laura Shigihara
No stress	Laurent Wolf
American National Anthem	LeAnn Rhimes
Can't Fight The Moonlight	LeAnn Rimes
Can't Fight The Moonlight [VIDEO]	LeAnn Rimes
She Ain't Got	LeToya
I'd give my Life for You	Lea Salonga
Stairway to Heaven	Led Zeppelin
Battle Hymn of The Republic	Lee Greenwood
God Bless The USA	Lee Greenwood
My country tis of thee	Lee Greenwood
Proud To Be An American	Lee Greenwood
The Wind Beneath My Wings	Lee Greenwood
Unknown Stuntman	Lee Majors
50-50	Lemar
50-50 (Karaoke)	Lemar
50/50	Lemar
It's Not That Easy	Lemar
Satellite	Lena Meyer-Landrut
Dansa I Neon	Lena Philipsson
Everything At Once	Lenka
Are You Gonna Go My Way [VIDEO]	Lenny Kravitz
Fly Away [VIDEO]	Lenny Kravitz
I'll Be Waiting [VIDEO]	Lenny Kravitz
All by myself	Leona Lewis
Better in Time	Leona Lewis
Bleeding Love	Leona Lewis
Forgive me	Leona Lewis
Chelsea Hotel Nr2	Leonard Cohen
Ich hab geträumt vor langer Zeit	Les Misérables
I dreamed a dream	Les miserables 10th anniversary
Der Ganze Bus Muss Pipi	Libero 5
Just A Little	Liberty X
Just a Little	Liberty X
Just a Little (Karaoke)	Liberty X
First Time	Lifehouse
Hai Un Momento Dio	Ligabue
Ho Perso Le Parole	Ligabue
Ho messo via	Ligabue
Il Mio Nome è Mai Più	Ligabue
Il centro del mondo	Ligabue
Niente Paura	Ligabue
Piccola stella senza cielo	Ligabue
Tra Palco E Realta'	Ligabue
Una Vita Da Mediano	Ligabue
Urlando contro il celo	Ligabue
Viva!	Ligabue
Three Lions	Lightning Seeds
Fuck You	Lily Allen
LDN [VIDEO]	Lily Allen
Littlest Things	Lily Allen
Smile [VIDEO]	Lily Allen
The Fear	Lily Allen
The Never Ending Story	Limahl
The Never Ending Story (Duett)	Limahl
The NeverEnding Story	Limahl
Behind blue eyes	Limp Bizkit
Build a Bridge	Limp Bizkit
Faith	Limp Bizkit
Re-arranged	Limp Bizkit
Take A Look Around	Limp Bizkit
The One	Limp Bizkit
Jag Ljuger Så Bra	Linda Bengtzing
Blue Bayou	Linda Ronstadt
A Place For My Head	Linkin Park
Bleed It Out	Linkin Park
Breaking The Habit	Linkin Park
Breaking The Habit [VIDEO]	Linkin Park
Castle Of Glass	Linkin Park
Crawling	Linkin Park
Crawling [VIDEO]	Linkin Park
Don't Stay [VIDEO]	Linkin Park
Faint [VIDEO]	Linkin Park
From the inside	Linkin Park
Given Up	Linkin Park
In The End [VIDEO]	Linkin Park
Leave Out All The Rest [VIDEO]	Linkin Park
Little Boxes (Weeds Theme) [VIDEO]	Linkin Park
My December	Linkin Park
New Divide	Linkin Park
No Roads Left	Linkin Park
Numb [VIDEO]	Linkin Park
One Step Closer [VIDEO]	Linkin Park
Points of Authority	Linkin Park
Powerless	Linkin Park
Shadow Of The Day	Linkin Park
Somwhere I Belong	Linkin Park
The Catalyst	Linkin Park
The Little Things Give You Away	Linkin Park
What I've done	Linkin Park
I just can't wait	Lion King
All Night Long	Lionel Richie
My Destiny	Lionel Richie
Say You, Say Me	Lionel Richie
Funky Town	Lipps Inc
Narcotic [VIDEO]	Liquido
Stay	Lisa Loeb
Stay (I Missed You)	Lisa Loeb
All Around The World	Lisa Stansfield
Tex	Litfiba
Vivere il mio tempo	Litfiba
The Loco-Motion	Little Eva
Tutti Frutti	Little Richard
Tutti Frutti [VIDEO]	Little Richard
Skid Row (Downtown)	Little Shop Of Horrors
Bada bambina	Little Tony
Kanashimi wo yasashisa ni	Little by little
Kimi monogatari	Little by little
Get It Shawty	Lloyd
Id Love You To Want Me	Lobo
Seemann, Deine Heimat Ist Das Meer	Lolita
Wenn Du Denkst Du Denkst	Lollies
Amazed	Lone Star
Amazed	Lonestar
Hard Rock Hallelujah	Lordi
Il Mare d'Inverno	Loredana Berte'
Euphoria	Loreen
La notte vola	Lorella Cuccarini
Sin Documentos	Los Rodríguez
Macarena	Los del Rio
Last Summer	Lost Prophets
Wake Up (Make A Move)	Lostprophets
Fyra Bugg Och en Coca Cola	Lotta Engberg
Hamburg meine Perle	Lotto King Karl
Mambo No. 5	Lou Bega
Mambo No. 5 [VIDEO]	Lou Bega
What A Wonderful World	Louis Armstrong
Mädchen	Lucilectric
7 e 40	Lucio Battisti
La Canzone del Sole	Lucio Battisti
Una donna per amico	Lucio Battisti
Attenti Al Lupo	Lucio Dalla
Zeit Für Helden	Luka Neuser
50 Special	Luna Pop
Se ci sarai	Lunapop
Lupin	Lupin
Never Too Much	Luther Vandross
Super Sommer	Luttenberger-Klug
Schafft die Männer 'ran	Lyn Liechty
Sweet Home Alabama	Lynyrd Skynyrd
Movin' On Up	M People
Carolina	M-Clan
Movin' On Up	M-People
Don't Say You Love Me	M2M
Mirror, Mirror	M2M
U Can't Touch This	MC Hammer
Kids	MGMT
Zirkus	MIA.
Kocham Ciê, Kochanie Moje	Maanam
BegginÂ´	Madcon
Freaky Like Me	Madcon feat. Ameerah
Freaky Like Me (Duett)	Madcon feat. Ameerah
House Of Fun	Madness
Our House	Madness
American Pie	Madonna
Burning Up	Madonna
Don't Cry For Me Argentina	Madonna
Don't Tell Me	Madonna
Drowned World (Substitute For Love)	Madonna
Fever	Madonna
Frozen	Madonna
Get Into The Groove	Madonna
Give It To Me	Madonna
High Flying, Adored	Madonna
Holiday	Madonna
Hollywood	Madonna
Hung up	Madonna
La Isla Bonita	Madonna
Like A Prayer	Madonna
Like A Virgin	Madonna
Like a Virgin	Madonna
Like a Virgin (Karaoke)	Madonna
Material Girl	Madonna
Papa Don't Preach	Madonna
Sorry	Madonna
Take A Bow	Madonna
4 Minutes	Madonna feat. Justin Timberlake
4 Minutes [VIDEO]	Madonna feat. Justin Timberlake
Du Schreibst Geschichte	Madsen
Du schreibst Geschichte	Madsen
Vielleicht	Madsen
Imiê Deszczu	Mafia
För Kung Och Fosterland	Magnus Uggla
A ja wolê moj¹ mamê	Majka Je¿owska
Down In The Past	Mando Diao
I Wanna Be With You	Mandy Moore
Only Hope	Mandy Moore
Do Wah Diddy Diddy	Manfred Mann
If You Tolerate This Your Children Will Be Next	Manic Street Preachers
Carry on	Manowar
Heart Of Steel	Manowar
Warriors Of The World	Manowar
Clavado en un bar	Maná
Something's Gotten Hold Of My Heart (Gene)	Marc Almond feat. Gene Pitney
Something's Gotten Hold Of My Heart (Marc)	Marc Almond feat. Gene Pitney
Engel aus Kristall	Marc Clear
Walking In Memphis	Marc Cohn
Nell'aria	Marcella Bella
Herzfest	Marco Bandero
Vaffanculo	Marco Masini
Just hold me	Maria Mena
Lullaby	Maria Mena
All I Want For Christmas is You	Mariah Carey
Hero	Mariah Carey
It's Like That	Mariah Carey
Obsessed	Mariah Carey
We belong together	Mariah Carey
Without You	Mariah Carey
Er gehoert zu mir	Marianne Rosenberg
Er gehört zu mir [VIDEO]	Marianne Rosenberg
Marleen	Marianne Rosenberg
ErGehortZuMir	MarianneRosenberg
Fire And Ice	Marietta
Kayleigh	Marillion
Personal Jesus [VIDEO]	Marilyn Manson
Tainted Love	Marilyn Manson
This Is The New Shit	Marilyn Manson
Primavera	Marina Rei
If A Song Could Get Me You	Marit Larsen
Es geht mir gut	Marius Müller Westernhagen
Freiheit	Marius Müller Westernhagen
Freiheit (Live)	Marius Müller Westernhagen
Johnny Walker (Live)	Marius Müller Westernhagen
Sexy	Marius Müller Westernhagen
Sexy - Live [VIDEO]	Marius Müller Westernhagen
Willenlos	Marius Müller Westernhagen
Tears Don't Lie	Mark 'Oh
Sailing to Philadelphia	Mark Knopfler
You can get it	Mark Medlock & Dieter Bohlen
Stop Me	Mark Ronson
Valerie [VIDEO]	Mark Ronson feat. Amy Winehouse
Värsta Schlagern	Markoolio Och Linda Bengtzing
Ich will Spaß	Markus
Das rote Pferd	Markus Becker
Die Bunte Kuh	Markus Becker
Ich bin von Kopf bis Fuß auf Liebe eingestellt	Marlene Dietrich
New Age	Marlon Roudette
Makes Me Wonder	Maroon 5
Makes Me Wonder [VIDEO]	Maroon 5
She Will Be Loved [VIDEO]	Maroon 5
Sunday Morning	Maroon 5
This Love [VIDEO]	Maroon 5
Wake Up Call	Maroon 5
Won´t go home without you	Maroon 5
Moves Like Jagger	Maroon 5 feat. Christina Aguilera
Moves Like Jagger	Maroon 5 ft. Christina Aguilera
This Love	Maroon5
Dancing In The City	Marshall Hain
Desesperada	Marta Sánchez
Lila Wolken	Marteria ft. Yasha & Miss Platnum
Jimmy Mack	Martha Reeves & The Vandellas
Nowhere To Run	Martha Reeves & The Vandellas
Dancing In The Street	Martha Reeves And The Vandellas
Angel Of Berlin	Martin Kesici
Las Vegas	Martin Stenmarck
A Broken Wing	Martina McBride
Over The Rainbow	Marusha
I Heard It Through The Grapevine	Marvin Gaye
I Heard It Through The Grapevine [VIDEO]	Marvin Gaye
Let's Get It On	Marvin Gaye
Sexual Healing	Marvin Gaye
What's Going On	Marvin Gaye
It Takes Two (Kim)	Marvin Gaye & Kim Weston
It Takes Two (Marvin )	Marvin Gaye & Kim Weston
Ain't No Mountain High Enough [VIDEO]	Marvin Gaye And Tammii Tarrelle
Pinocchio	Mary Roos
My Guy	Mary Wells
Rush the floor	Massari feat. Belly
How Far We've Come	Matchbox Twenty
Big City Life [VIDEO]	Mattafix
Ich hab' geträumt von dir (Remastered)	Matthias Reim
Verdammt Ich Lieb' Dich	Matthias Reim
Alter Weg	Max Herre
1ste Liebe (Joy)	Max Herre mit Joy Denalane
1ste Liebe (Max Herre)	Max Herre mit Joy Denalane
Can't wait until tonight	Max Mutzke
Mezzo pieno o Mezzo vuoto	Max Pezzali
Kein Schwein ruft mich an	Max Raabe
Rain In May	Max Werner
Close To You	Maxi Priest
Apply Some Pressure	Maximo Park
Apply Some Pressure	Maxïmo Park
Hautnah	Maya Saban
Das Alles Ändert Nichts Daran	Maya Saban Feat. Cosmo Klein
Hang on Sloopy	McCoys
Obviously	McFly
All my lovin'	Me First & the Gimme Gimmes
Ain't No Sunshine	Me First And The Gimme Gimmes
Mandy	Me First And The Gimme Gimmes
Uptown Girl	Me First And The Gimme Gimmes
I'd Do Anything For Love (But I Won't Do That)	Meat Loaf
I'd Do Anything for Love (But I Won't Do That) [VIDEO]	Meat Loaf
Objects In The Rear View Mirror May Appear Closer Than They Are	Meat Loaf
Rock And Roll Dreams Come Through	Meat Loaf
Two Out Of Three Ain't Bad	Meat Loaf
I'd Do Anything for Love (But I Won't Do That)	Meatloaf
Perdido en mi habitacion	Mecano
You And I	Medina
Almost honest	Megadeth
Hangar 18	Megadeth
Symphony of destruction	Megadeth
Tornado of souls	Megadeth
À tout le monde	Megadeth feat. Cristina Scabbia
Respectable	Mel And Kim
Never Be The Same Again	Melanie C
First Day Of My Life	Melanie C.
Love How You Love Me	Melanie Thornton
Con la Luna llena	Melendi
Like The Way I Do	Melissa Etheridge
Was Geht Ab Mit Der Liebe	Mellow Mark
Down Under	Men At Work
Who Can It Be Now	Men At Work
Bitch	Meredith Brooks
Ain´t my bitch	Metallica
And justice for all	Metallica
Battery	Metallica
Blackened	Metallica
Blitzkrieg	Metallica
Crash course in brain surgery	Metallica
Creeping Death	Metallica
Damage Inc.	Metallica
Die, Die My Darling	Metallica
Enter Sandman	Metallica
Fade To Black	Metallica
Fight Fire With Fire	Metallica
For Whom the Bell Tolls	Metallica
Harvester of Sorrow	Metallica
Hero of the day	Metallica
Holier than thou	Metallica
I disappear	Metallica
Mama said	Metallica
Master Of Puppets	Metallica
Nothing Else Matters	Metallica
One	Metallica
Ride the lightning	Metallica
Sad But True	Metallica
Seek and Destroy	Metallica
The Day That Never Comes	Metallica
The Memory Remains	Metallica
The Unforgiven	Metallica
The Unforgiven I	Metallica
The Unforgiven II	Metallica
The Unforgiven Ii	Metallica
The unforgiven III	Metallica
Welcome Home (Sanitarium)	Metallica
Whiplash	Metallica
Whiskey In The Jar	Metallica
Whiskey in the jar	Metallica
Enter Sandman	Metallica & Symphony
Nothing Else Matters	Metallica & Symphony
Shake It	Metro Station
Tanz Der Moleküle	Mia
Tanz Der Moleküle [VIDEO]	Mia
Mad World	Michael Andrews Feat. Gary Jules
Mad World [VIDEO]	Michael Andrews Feat. Gary Jules
Home [VIDEO]	Michael Bublé
Baby, du bist nicht alleine	Michael Holm
Lucille	Michael Holm
Mendocino	Michael Holm
Tranen Lugen Nicht	Michael Holm
Bad	Michael Jackson
Bad [VIDEO]	Michael Jackson
Beat It	Michael Jackson
Beat It [VIDEO]	Michael Jackson
Ben	Michael Jackson
Billie Jean	Michael Jackson
Billie Jean [VIDEO]	Michael Jackson
Black Or White	Michael Jackson
Black or White	Michael Jackson
Dirty Diana	Michael Jackson
Don't Stop Till You Get Enough	Michael Jackson
Don't stop till you get enough	Michael Jackson
Earth Song	Michael Jackson
Earth Song [VIDEO]	Michael Jackson
Give in to me	Michael Jackson
Heal The World	Michael Jackson
Heal the World	Michael Jackson
History	Michael Jackson
Human Nature	Michael Jackson
Is It Scary	Michael Jackson
Liberian Girl	Michael Jackson
Man in the Mirror	Michael Jackson
Man in the mirror [VIDEO]	Michael Jackson
Smooth Criminal	Michael Jackson
Stranger In Moscow	Michael Jackson
The Way You Make Me Feel	Michael Jackson
The Way You Make Me Feel [VIDEO]	Michael Jackson
This Is It	Michael Jackson
Thriller	Michael Jackson
Wanna Be Starting Something	Michael Jackson
You Are Not Alone [VIDEO]	Michael Jackson
You are not alone	Michael Jackson
We are the world	Michael Jackson & Friends
Scream	Michael Jackson & Janet Jackson
Hold My Hand (Duett)	Michael Jackson ft. Akon
Blinded by the light	Michael Mind feat. Manfred Mann's Earth Band
Nina	Michael Wendler
Sie Liebt Den DJ	Michael Wendler
Tong Hua [VIDEO]	Michael Wong
Ai Se Eu Te Pego	Michel Teló
Cinque giorni	Michele Zarrillo
Kinderaugen	Michelle
Wer Liebe lebt	Michelle
Wirst du noch da sein	Michelle
Breathe	Michelle Branch
The Greatest	Michelle Williams
Thriller	Mickael Jackson
Finger Im Po Mexiko	Mickie Krause
Himbeereis	Mickie Krause
Laudato Si	Mickie Krause
Nichts reimt sich auf Uschi	Mickie Krause
Orange Tragt Nur Die Mullabfuhr	Mickie Krause
Zieh dich aus kleine Maus	Mickie Krause
Chirpy Chirpy Cheep Cheep	Middle of the Road
Beds Are Burning [VIDEO]	Midnight Oil
Amante bandido	Miguel Bosé
Bienvenidos	Miguel Ríos
Big Girl You Are Beautiful	Mika
Big Girl You Are Beautiful [VIDEO]	Mika
Grace Kelly [VIDEO]	Mika
Happy Ending	Mika
Lollipop	Mika
Relax, Take It Easy	Mika
Over My Shoulder	Mike And The Mechanics
Eskimo	Mike Der Bademeister
Der Nippel	Mike Krüger
Shadow On The Wall	Mike Oldfield & Roger Chapman
Moonlight Shadow [VIDEO]	Mike Oldfield feat. Maggie Reilly
TV Theme	Mila Superstar
7 Things	Miley Cyrus
Nobody's perfect	Miley Cyrus
Seven Things	Miley Cyrus
Who Owns My Heart	Miley Cyrus
Livin' a lie	Milk Inc.
No Cigar	Millencolin
Girl You Know It's True	Milli Vanilli
Ayo Technology	Milow
You Don't Know	Milow
Acqua e Sale	Mina e Celentano
Brivido felino	Mina e Celentano
Kerosene	Miranda Lambert
Scandalous	Mis-Teeq
Scandalous (Karaoke)	Mis-Teeq
Scandalous (Karaoke) [VIDEO]	Misteeq
Scandalous [VIDEO]	Misteeq
Eins, zwei, Polizei	Mo-Do
Beautiful	Moby
Lift me up	Moby
Porcelain	Moby
We Are All Made Of Stars	Moby
Brother Louie	Modern Talking
Cheri Cheri Lady	Modern Talking
You're My Heart, You're My Soul	Modern Talking
Lady (Hear Me Tonight)	Modjo
The Time Is Now	Moloko
Daydream Believer	Monkees
I'm A Believer	Monkees
Hot Summer	Monrose
Shame	Monrose
My Town	Montgomery Gentry
What Do Ya Think About That	Montgomery Gentry
Always look on the bright side of life	Monty Python
Nights in white satin	Moody blues
Ace of Spades	Motorhead
Ace of Spades (Karaoke)	Motorhead
Ace of Spades	Motörhead
Come What May (CD-Version)	Moulin Rouge
Lady Marmalade (Christina ft. Mya, Pink & Lil Kim)	Moulin Rouge
The Show Must Go On (CD-Version)	Moulin Rouge
The Show Must Go On (Movie-Version)	Moulin Rouge
Your Song	Moulin Rouge
Herr Rossi Sucht Das Glück	Moulinettes
To Be With You	Mr Big
Broken Wings	Mr Mister
Kyrie	Mr Mister
To Be With You	Mr. Big
Broken Wings	Mr. Mister
Kyrie	Mr. Mister
Broken Wings	Mr.Mister
Broken Wings (Kar)	Mr.Mister
I'll Make A Man Out Of You	Mulan
Germans	Mundstuhl
In The Summertime	Mungo Jerry
White Wedding	Murderdolls
Muscle Museum	Muse
Starlight	Muse
Survival	Muse
Survival [Album Version]	Muse
Survival [KAR]	Muse
Time Is Running Out	Muse
Undisclosed Desires	Muse
Uprising	Muse
Helena	My Chemical Romance
Welcome To The Black Parade	My Chemical Romance
Art of the Dress	My Little Pony
At the Gala	My Little Pony
Big Brother Best Friend Forever	My Little Pony
Find a Pet	My Little Pony
Giggle at The Ghostly	My Little Pony
Hush Now Quiet Now	My Little Pony
Love is in Bloom	My Little Pony
Pony Pokey	My Little Pony
So Many Wonders	My Little Pony
The Perfect Stallion	My Little Pony
Theme	My Little Pony
This Day Aria	My Little Pony
Winter Wrap Up	My Little Pony
You Gotta Share	My Little Pony
ï»¿#TITLE:Becoming Popular	My Little Pony
ï»¿#TITLE:Smile Smile Smile	My Little Pony
Teenagers	MyChemicalRomance
Ohne Dich	Münchener Freiheit
Loko	Mürfila
Bye Bye Bye [VIDEO]	N'Sync
It's Gonna Be Me	N'Sync
Tearin' Up My Heart	N'Sync
This I Promise You	N'Sync
Laura non c'e	NEK
La chica de ayer	Nacha Pop
The Secret Is Love	Nadine Beiler
Bang Bang	Nancy Sinatra
These Boot Are Made For Walking	Nancy Sinatra
Håll Om Mig	Nanne Grönvall
En El 2000	Natalia Lafourcade
Torn	Natalie Imbruglia
Single	Natasha Bedingfield
Soulmate	Natasha Bedingfield
These Words	Natasha Bedingfield
These Words [VIDEO]	Natasha Bedingfield
Je N'ai Que Mon Ame	Natasha St-Pier
Nos Rendez-vous	Natasha St-Pier
Un Ange Frappe A Ma Porte	Natasha St-pier
Why (Does Your Love Hurt So Much)	Natasha Thomas
Noches de Bohemia	Navajita Plateá
Beautiful Monster	Ne-Yo
Closer	Ne-Yo
Forever Now	Ne-Yo
Miss Independent	Ne-Yo
Sexy Love [VIDEO]	Ne-Yo
ï»¿#TITLE:Because Of You	Ne-Yo
Estate	Negramaro
Solo3min	Negramaro
Via Le Mani Dagli Occhi	Negramaro
Magnolia	Negrita
Rotolando verso sud	Negrita
Oh Carol	Neil Sedaka
Speedy Gonzales	Neil Sedaka
Stupid Cupid	Neil Sedaka
Heart Of Gold	Neil Young
Laura Non C'e	Nek
Se io non avessi te	Nek
Juppihippipunkkari	Neljä Ruusua
Just A Dream	Nelly
All Good Things (come to an end)	Nelly Furtado
All Good Things [VIDEO]	Nelly Furtado
Forca [VIDEO]	Nelly Furtado
I'm Like A Bird [VIDEO]	Nelly Furtado
Maneater	Nelly Furtado
Powerless [VIDEO]	Nelly Furtado
Promiscuous	Nelly Furtado
Promiscuous [VIDEO]	Nelly Furtado
Say It Right (Karaoke) [VIDEO]	Nelly Furtado
Say It Right [VIDEO]	Nelly Furtado
Try [VIDEO]	Nelly Furtado
Turn off the light [VIDEO]	Nelly Furtado
99 Luftballons	Nena
99 Luftballons [VIDEO]	Nena
99 Red Balloons	Nena
99 Red Balloons [VIDEO]	Nena
Irgendwie, Irgendwo, Irgendwann	Nena
Leuchtturm (New Version)	Nena
Liebe ist	Nena
Anyplace, Anywhere, Anytime (Duett)	Nena ft. Kim Wilde
Ich Kann Nix Dafür	Nena, Olli & Remmler
Amore per Sempre	Nevio Passaro
Dressed To Kill	New Found Glory
Step By Step	New Kids On The Block
Step By Step [VIDEO]	New Kids On The Block
51st State	New Model Army
So Sick	Neyo
Ich Will Dich Fur Immer	Nic
Dan Ni Gu Dan Ni Hui Xiang Qi Shui	Nicholas Teo
Wang Zi [VIDEO]	Nicholas Teo
We Are All The Winners	Nick Borgen
Where The Wild Roses Grow	Nick Cave & The Bad Seeds and Kylie Minogue
Where The Wild Roses Grow	Nick Cave And Kylie Minogue
Where The Wild Roses Grow	Nick Cave and Kylie Minogue
Far Away	Nickelback
How You Remind Me	Nickelback
Rockstar	Nickelback
Savin' Me	Nickelback
Too Bad	Nickelback
When We Stand Together	Nickelback
I bin a bayrisches Cowgirl	Nicki
Va Va Voom	Nicki Minaj
Schmidtchen Schleicher	Nico Haak
Ein Bisschen Frieden	Nicole
Elephant Love Medley	Nicole Kidman & Ewan Mcgregor
Alumina	Nightmare
The world	Nightmare
Amaranth	Nightwish
Angels fall first	Nightwish
Bye Bye Beautiful	Nightwish
Dead Gardens	Nightwish
Fantasmic	Nightwish
Fishmaster [wishmaster Misheard Lyrics]	Nightwish
Over the hills and far away	Nightwish
Phantom Of The Opera	Nightwish
Sleeping Sun	Nightwish
The Islander	Nightwish
The Kinslayer	Nightwish
Wanderlust	Nightwish
Wish I Had An Angel	Nightwish
Wishmaster	Nightwish
The Riddle	Nik Kershaw
Der Mann Im Mond	Nik P
Nils Holgersson	Nils
Without You	Nilsson
Without You [VIDEO]	Nilsson
Leise rieselt der Schnee	Nina & Mike
Closer	Nine Inch Nails
Every Day Is Exactly The Same	Nine Inch Nails
The Perfect Drug	Nine Inch Nails
We're In This Together	Nine Inch Nails
Wish	Nine Inch Nails
Un beso y una flor	Nino Bravo
Jenseits Von Eden	Nino De Angelo
About A Girl	Nirvana
About a Girl (Unplugged)	Nirvana
Come As You Are	Nirvana
Dumb	Nirvana
Heart-Shaped Box	Nirvana
In Bloom	Nirvana
Jesus don't want me for a sunbeam	Nirvana
Lake of Fire (unplugged)	Nirvana
Lithium	Nirvana
Pennyroyal Tea (unplugged)	Nirvana
Rape Me	Nirvana
Sliver	Nirvana
Smells Like Teen Spirit	Nirvana
Where did you sleep last night (unplugged)	Nirvana
Daylight In Your Eyes	No Angels
Like Ice In The Sunshine	No Angels
Someday	No Angels
There must be an Angel	No Angels
Don't speak	No Doubt
Ex-Girlfriend	No Doubt
It´s my life [VIDEO]	No Doubt
Just A Girl	No Doubt
Spiderwebs	No Doubt
Sunday Morning	No Doubt
Underneath it All [VIDEO]	No Doubt
Where Do You Go [VIDEO]	No Mercy
Liberi Fatali	Nobou Uemsatu
Ring Of Steel	Nocturnal Rites
Io Vagabondo	Nomadi
Un Giorno Insieme	Nomadi
Don't Know Why	Norah Jones
Sunrise [VIDEO]	Norah Jones
Spirit In The Sky	Norman Greenbaum
Belle	Notre Dame de Paris
Dragostea Din Tei	O-Zone
Love and Memories	O.A.R
Love And Memories	O.A.R.
How Bizarre	OMC
Heaven Is A Halfpipe [VIDEO]	OPM
All Around The World	Oasis
Champagne Supernova	Oasis
Don't Look Back in Anger	Oasis
Go let it out	Oasis
Stop Crying Your Heart Out [VIDEO]	Oasis
Wonderwall	Oasis
Gone Away	Offspring
Self Esteem	Offspring
The Kids Aren't Alright	Offspring
Why Don't You Get a Job	Offspring
An Alle Ladies	Ohrbooten
Bewegung	Ohrbooten
Man Lebt Nur Einmal	Ohrbooten
Man Lebt Nur Einmal [VIDEO]	Ohrbooten
Cowboy Und Indianer	Olaf Henning
Was Kostet Die Welt	Olesoul
Flugzeuge Im Bauch	Oli P.
Schwarz Und Weiss	Oliver Pocher
Apologize	One Republic
Stop And Stare [VIDEO]	One Republic
In München steht ein Hofbräuhaus	Onkel Tom Angelripper
Johnny Walker	Onkel Tom Angelripper
Brennende Liebe	Oomph! ft. L'ame Immortelle
Get What You Want	Operator Please
Windowpane	Opeth
Live Is Life	Opus
Loving You Girl	Opus X
She's Got That Light (Orange Mix)	Orange Blue
Bright Idea	Orson
Szklana Pogoda	Ostrowska
Otto-Arschgesicht	Otto
Im Wagen vor mir	Otto Waalkes
Wir haben Grund zum Feiern	Otto Waalkes
Roses	OutKast
Roses	Outcast
Roses [VIDEO]	Outcast
Hey Ya	Outkast
Idlewild Blues (Don't Chu Worry 'Bout Me)	Outkast
Dreamer	Ozzy Osbourne
Mr. Crowley	Ozzy Osbourne
We Love To Love	P. M. Sampson
Pikkuveli	PMMP
Eine Frau Die Mich Nach Hause Trägt	PS Alex
Ein Graues Haar	PUR
Hab mich wieder mal an dir betrunken	PUR
Halt dich fest	PUR
Eleanor Rigby	Pain
Amici come prima	Paola e Chiara
Vamos a bailar	Paola e Chiara
Nasz Disneyland	Papa Dance
Last Resort	Papa Roach
Stars are Blind	Paris Hilton
Der Betze Ruft	Party Animals
Let Her Go	Passenger
Love Letters In The Sand	Pat Boone
Born To Be Alive	Patrick Hernandez
5 Days	Patrick Nuo
She´s Like The Wind [VIDEO]	Patrick Swayze
Crazy	Patsy Cline
Dimmi che non vuoi morire	Patty Pravo
Hey Paula	Paul And Paula
I'm Just A Lonely Boy	Paul Anka
Sixteen Candles	Paul Anka
Stand by me	Paul Anka
Mull of Kintyre	Paul McCartney
Say Say Say (Duett)	Paul McCartney & Michael Jackson
J'ai des choses a te dire	Pearl
Alive	Pearl Jam
Alive [VIDEO]	Pearl Jam
Black	Pearl Jam
Even Flow	Pearl Jam
Jeremy	Pearl Jam
Moottoritie On Kuuma	Pelle Miljoona Oy
Autobiografia	Perfekt
Always On My Mind	Pet Shop Boys
Always On My Mind [VIDEO]	Pet Shop Boys
Go West	Pet Shop Boys
It's A Sin	Pet Shop Boys
What Have I Done To Deserve This (Duett)	Pet Shop Boys With Dusty Springfield
Die Kleine Kneipe	Peter Alexander
Die süßesten Früchte	Peter Alexander & Leila Negra
Mysterious Girl	Peter Andre
Young Folks	Peter Bjorn And John Featuring Victoria Bergsman
Glory Of Love	Peter Cetera
Du entschuldige i kenn di	Peter Cornelius
Reif für die Insel	Peter Cornelius
Haus am See	Peter Fox
Solsbury Hill	Peter Gabriel
Let It Be	Peter Gabriel & Kate Bush
Sonnendeck	Peter Licht
Nessaja	Peter Maffay
So bist Du	Peter Maffay
Und Es War Sommer	Peter Maffay
Über sieben Brücken mußt Du gehn	Peter Maffay
Flieg Ins Glück	Peter Pan
Following The Leader	Peter Pan
Geh'n Wir Auf Den Kriegspfad	Peter Pan
You Can Fly	Peter Pan
Major Tom	Peter Schilling
Terra Titanic	Peter Schilling
Joana	Peter Wackel
Ladioo	Peter Wackel
Manchmal Mochte Ich Schon Mit Dir	Peter Wackel
Vollgas	Peter Wackel
Ü 30	Peter Wackel
500 Miles	Peter, Paul & Mary
Puff the magic dragon	Peter, Paul & Mary
Downtown	Petula Clark
Downtown (Karaoke)	Petula Clark
Downtown (Karaoke) [VIDEO]	Petula Clark
Downtown [VIDEO]	Petula Clark
California	Phantom Planet
Another Day In Paradise [VIDEO]	Phil Collins
Can't Stop Loving You	Phil Collins
Sommerflørt	Philip & Sandra
Froh dabei zu sein	Philipp Poisel
Another Day In Paradise	Phill Collins
Bohemian Rhapsody (Live In Australia)	Pink
Dear Mr. President	Pink
Don´t let me get me	Pink
Family Portrait [VIDEO]	Pink
Get This Party Started	Pink
Just Like A Pill	Pink
Lets get this party started	Pink
Lets get this party started (Karaoke)	Pink
Lets get this party started (Karaoke) [VIDEO]	Pink
Lets get this party started [VIDEO]	Pink
Nobody Knows [VIDEO]	Pink
Please Don't Leave Me	Pink
So What	Pink
Sober	Pink
Stupid Girls	Pink
There You Go [VIDEO]	Pink
U & Ur Hand [VIDEO]	Pink
Who Knew	Pink
Who Knew (Karaoke) [VIDEO]	Pink
Who Knew [VIDEO]	Pink
Another Brick In The Wall [VIDEO]	Pink Floyd
Hey You	Pink Floyd
Wish You Were Here	Pink Floyd
Der Pinky und der Brain	Pinky und Brain
Här kommer Pippi Langstrump	Pippi Langstrump
Hey Pippi Langstrumpf	Pippi Langstrumpf
Give Me Everything	Pitbull feat. Ne-Yo
Every Me And Every You	Placebo
1, 2, 3, 4	Plain White T's
Hey There Delilah	Plain White T's
Hey There Delilah [VIDEO]	Plain White T's
1, 2, 3, 4	Plain White T´s
LocoRoco Title Theme	PlayStationPortable
Wenn Jetzt Sommer Wär	Pohlmann
Every Rose Has Its Thorn	Poison
Unskinny Bop	Poison
Theme	Pokemon
Message in a bottle	Police (The)
Uomini Soli	Pooh
Kuuma Kesä	Popeda
Space Invaders	Pornophonique
Space Invaders (Kar)	Pornophonique
I bambini fanno oh	Povia
Como hemos cambiado	Presuntos Implicados
Brass In Pocket	Pretenders
Kiss	Prince
Read All About It	Professor Green ft. Emeli Sande
Acido acida	Prozac+
Gangnam Style	Psy
She hates me	Puddle of Mudd
Common People	Pulp
Disco 2000	Pulp
Abenteuerland	Pur
Lena	Pur
Partyhitmix (Lange Version)	Pur
Buttons	Pussycat Dolls
Don't Cha (Radio Edit)	Pussycat Dolls
I Hate This Part	Pussycat Dolls
Jai Ho (You Are My Destiny)	Pussycat Dolls
Stick Wit U	Pussycat Dolls
Stickwitu	Pussycat Dolls
Beep	Pussycat Dolls (Feat. Will.i.am)
Bu Rang Wo De Yan Lei Pei Wo Guo Ye [VIDEO]	Qi Qin
'39 [VIDEO]	Queen
Another One Bites The Dust	Queen
Bicycle Race (Backing)	Queen
Bicycle Race (Freddie)	Queen
Bohemian Rhapsody (BACKING M)	Queen
Bohemian Rhapsody (Duett)	Queen
Bohemian Rhapsody (Freddie)	Queen
Breakthru	Queen
Crazy Little Thing Called Love	Queen
Don't Stop Me Now	Queen
Fat Bottomed Girls (BACKING M)	Queen
Fat Bottomed Girls (Freddie)	Queen
Good Old-Fashioned Lover Boy [VIDEO]	Queen
Hammer To Fall	Queen
I Want It All	Queen
I Want To Break Free	Queen
I Was Born To Love You [VIDEO]	Queen
In Only Seven Days	Queen
Innuendo	Queen
Killer Queen	Queen
Love of my life	Queen
One Vision	Queen
Play The Game (BACKING M)	Queen
Play The Game (Freddie)	Queen
Radio Ga Ga [VIDEO]	Queen
Somebody To Love	Queen
Thank God It's Christmas	Queen
The Show Must Go On	Queen
The Show Must Go On [VIDEO]	Queen
These Are The Days Of Our Lives	Queen
Tie Your Mother Down	Queen
Too Much Love Will Kill You	Queen
Under Pressure (David)	Queen
Under Pressure (Freddie)	Queen
We Are The Champions	Queen
We Will Rock You	Queen
Who Wants To Live Forever	Queen
You're My Best Friend	Queen
Go With The Flow	Queens Of The Stone Age
Cum On Feel The Noize	Quiet Riot
I Believe I Can Fly	R Kelly
Daysleeper	R.E.M.
Everybody Hurts	R.E.M.
Imitation of Life	R.E.M.
It's The End Of The World	R.E.M.
Losing My Religion	R.E.M.
Man on the Moon	R.E.M.
Nightswimming	R.E.M.
Orange Crush	R.E.M.
Shiny Happy People	R.E.M.
Stand	R.E.M.
Strange Currencies	R.E.M.
The One I Love	R.E.M.
The Sidewinder Sleeps Tonite	R.E.M.
Turn This Club Around	R.I.O. ft. U-Jean
R.E.S.P.E.C.T.	RLP & Barbara Tucker
Harmonia	RYTHEM
Ich Kenne Nichts	RZA
Ich Kenne Nichts...	RZA
Was Kann Ich Denn Dafür ... (Dass Ich Schön Bin)	Rabaue
Creep	Radiohead
Exit Music (For a film)	Radiohead
Karma Police	Radiohead
Il battito animale	Raf
Sei la più bella del mondo	Raf
Bananaphone	Raffi
Clouds across the moon	Rah Band
Macho Macho	Rainhard Fendrich
Oben Ohne	Rainhard Fendrich
Weilst a Herz hast	Rainhard Fendrich
Streets of London	Ralph McTell
Amerika	Rammstein
Bück dich	Rammstein
Du Hast	Rammstein
Du Riechst So Gut	Rammstein
Engel (english Version)	Rammstein
Engel [VIDEO]	Rammstein
Feuer Frei	Rammstein
Mein Teil	Rammstein
Mutter	Rammstein
Nebel	Rammstein
Ohne Dich	Rammstein
Rosenrot	Rammstein
Seemann [VIDEO]	Rammstein
Blitzkrieg Bop	Ramones
Bless The Broken Road	Rascal Flats
Så Länge Vi Har Varann	Ratata & Frida
Hit the road Jack	Ray Charles
Ghostbusters	Ray Parker jr.
Golden Touch	Razorlight
Goldentouch	Razorlight
In The Morning	Razorlight
Somewhere Else	Razorlight
Wire To Wire	Razorlight
Supergirl	Reamonn
Through The Eyes Of A Child	Reamonn
Tonight	Reamonn
By the Way	Red Hot Chili Peppers
Californication	Red Hot Chili Peppers
Can't Stop	Red Hot Chili Peppers
Dani California	Red Hot Chili Peppers
Desecration Smile	Red Hot Chili Peppers
Otherside	Red Hot Chili Peppers
Snow (Hey oh)	Red Hot Chili Peppers
Soul To Squeeze	Red Hot Chili Peppers
The Adventures Of Raindance Maggie	Red Hot Chili Peppers
Under The Bridge	Red Hot Chili Peppers
Cotton Eye Joe [VIDEO]	Rednex
Macho Macho	Reinhard Fendrich
Über den Wolken	Reinhard Mey
I'll be there for you	Rembrandts
Amico	Renato Zero
Ready To Go	Republica
Si es tan solo amor	Revolver
Die Welt Steht Still	Revolverheld
Freunde Bleiben	Revolverheld
Generation Rock	Revolverheld
Helden 2008	Revolverheld
Mit Dir Chilln	Revolverheld
Fiesta Mexicana	Rex Gildo
Dawn Of Victory	Rhapsody
Emerald Sword	Rhapsody
Gargoyles Angels of Darkness	Rhapsody
Holy Thunderforce	Rhapsody
Knightrider Of Doom	Rhapsody
Queen Of The Dark Horizons	Rhapsody
The Magic Of The Wizard's Dreams	Rhapsody
The Wisdom Of The Kings	Rhapsody
Unholy Warcry	Rhapsody
Hey, hey, Wickie	Rheinländer
Wir Alle Wollen Immer Nur Das Eine	Rheinländer
Margherita	Riccardo Cocciante
Sará pérche ti amo	Ricchi e Poveri
Hazard	Richard Marx
Right Here Waiting [VIDEO]	Richard Marx
Reality	Richard Sanderson
Supa Richie	Richie
Dui Mian De Nu Hai Kan Guo Lai [VIDEO]	Richie Ren
Labamba	Richie Valens
Never gonna give you up	Rick Astley
Never gonna give you up (Karaoke)	Rick Astley
Never gonna give you up (Karaoke) [VIDEO]	Rick Astley
Never gonna give you up [VIDEO]	Rick Astley
Super Freak	Rick James
Can't Touch It	Ricki Lee
Livin' La Vida Loca	Ricky Martin
Livin' La Vida Loca (Karaoke)	Ricky Martin
Hello Mary Lou	Ricky Nelson
I'm Too Sexy	Right Said Fred
Stand Up For The Champions	Right Said Fred
You're My Mate [VIDEO]	Right Said Fred
Unchained Melody	Righteous Brothers
California King Bed	Rihanna
Disturbia [VIDEO]	Rihanna
Don't stop the music [VIDEO]	Rihanna
Pon De Replay	Rihanna
Russian Roulette [SC]	Rihanna
SOS	Rihanna
SOS [VIDEO]	Rihanna
Shut Up And Drive [VIDEO]	Rihanna
Take A Bow	Rihanna
Umbrella	Rihanna
Unfaithful [VIDEO]	Rihanna
We Ride [VIDEO]	Rihanna
We Found Love	Rihanna feat. Calvin Harris
Umbrella [VIDEO]	Rihanna feat. Jay-Z
Rehab	Rihanna feat. Justin Timberlake
Love The Way You Lie (Part II)	Rihanna ft. Eminem
Stay	Rihanna ft. Mikky Ekko
Aida	Rino Gaetano
Gianna	Rino Gaetano
Junimond	Rio Reiser
KÃ¶nig Von Deutschland	Rio Reiser
König Von Deutschland	Rio Reiser
Prayer of the Refugee	Rise Against
Cuore	Rita Pavone
Only To Be With You	Roachford
Dragula (Hot Rod Herman Remix)	Rob Zombie
Advertising Space [VIDEO]	Robbie Williams
Angels	Robbie Williams
Better Man	Robbie Williams
Come Undone	Robbie Williams
Come Undone [VIDEO]	Robbie Williams
Eternity	Robbie Williams
Feel [VIDEO]	Robbie Williams
Let Me Entertain You	Robbie Williams
Let Me Entertain You [VIDEO]	Robbie Williams
Let love be your energy [VIDEO]	Robbie Williams
Rock DJ [VIDEO]	Robbie Williams
She's Madonna	Robbie Williams
She's The One [VIDEO]	Robbie Williams
Tripping	Robbie Williams
Kids	Robbie Williams & Kylie Minogue
Something Stupid [VIDEO]	Robbie Williams & Nicole Kidman
Kids (Kylie)	Robbie Williams and Kylie Minogue
Kids (Robbie version) [VIDEO]	Robbie Williams and Kylie Minogue
Kids (Robbie)	Robbie Williams and Kylie Minogue
Kids [VIDEO]	Robbie Williams and Kylie Minogue
Niecierpliwi	Robert Chojnacki
Ein Bisschen Spa Muss Sein	Roberto Blanco
Show Me Love	Robyn
Marina	Rocco Granata
500 Miles	Rockapella
Sexual Healing	Rockapella
Under The Bridge	Rockapella
White Christmas	Rockapella
Wonderwall	Rockapella
Time Warp	Rocky Horror Show
Sailing	Rod Stewart
Die Liste	Roger Cicero
Die Liste [VIDEO]	Roger Cicero
Zieh Die Schuh Aus	Roger Cicero
När Vindarna Viskar Mitt Namn	Roger Pontare
Eloisa	Roger Whittaker
Lass mich bei Dir sein	Roger Whittaker
Wenn Es Dich Noch Gibt	Roger Whittaker
Dich Zu Lieben	Roland Kaiser
Manchmal möchte ich schon mit dir	Roland Kaiser
In Der Weihnachtsbäckerei	Rolf Zuckowski
Vorrei incontrarti fra 100 anni	Ron
Father And Son [VIDEO]	Ronan Keating
If Tomorrow Never Comes [VIDEO]	Ronan Keating
Life Is A Rollercoaster	Ronan Keating
When You Say Nothing At All	Ronan Keating
Father And Son	Ronan Keating featuring Yusuf
Es hängt ein Pferdehalfter an der Wand	Ronny
When Did Your Heart Go Missing?	Rooney
Mi Gato	Rosario
Aus Liebe Wollt Ich Alles Wissen	Rosenstolz
Es Könnt' Ein Anfang Sein	Rosenstolz
Ich Bin Ich (Wir Sind Wir) [VIDEO]	Rosenstolz
Ich Geh In Flammen Auf	Rosenstolz
Ich Geh' In Flammen Auf	Rosenstolz
Liebe Ist Alles	Rosenstolz
Wie Weit Ist Vorbei	Rosenstolz
Willkommen	Rosenstolz
Quiero besarte	Roser
Crash! Boom! Bang!	Roxette
How Do You Do	Roxette
It Must Have Been Love	Roxette
Listen To Your Heart	Roxette
Listen To Your Heart [VIDEO]	Roxette
Spending My Time	Roxette
The Look [VIDEO]	Roxette
Vulnerable	Roxette
Wish I Could Fly	Roxette
You Don't Understand Me	Roxette
Love Is The Drug	Roxy Music
Schon Ist Es Auf Der Welt Zu Sein	Roy Black & Anita
In Dreams	Roy Orbison
Oh Pretty Woman	Roy Orbison
Pretty Woman	Roy Orbison
Pretty Woman (Karaoke)	Roy Orbison
Tell Laura I Love Her	Roy Orbison
Córka Rybaka	Rudi Schuberth
Hallelujah	Rufus Wainwright
It's Tricky	Run DMC
Ut Mot Havet	Rune Rudberg
Das Fegerlied	Räuber
Ein Freund, Ein Guter Freund	Rühmann's (Sch)erben
Don't Stop Movin'	S Club 7
Don't Stop Movin' (Karaoke)	S Club 7
Don't Stop Movin' (Karaoke) [VIDEO]	S Club 7
Don't Stop Movin' [VIDEO]	S Club 7
Never Had a Dream Come True [VIDEO]	S Club 7
An jing le [VIDEO]	S.H.E
IOIO [VIDEO]	S.H.E
Re Dai Yu Lin [VIDEO]	S.H.E
Shi mian mai fu [VIDEO]	S.H.E
Super Star [VIDEO]	S.H.E
Anfang Anzufangen	SDP
Butterfly	SMiLE.dk
Gö du bleibst heit nacht bei mir	STS
Theme	Saber Rider
Push It	Salt 'N' Pepa
Push It [VIDEO]	Salt N' Pepa
Wonderful World	Sam Cooke
Wonderful world	Sam Cooke
Halte die Zeit	Samajona
So Schwer	Samajona
Touch Me (I Want Your Body)	Samantha Fox
Always Come Back to Your Love	Samantha Mumba
Giudizi Universali	Samuele Bersani
Tuhat Yt	Samuli Edelmann
Stumm	Samy Deluxe
I Wish I Was A Punk Rocker	Sandi Thom
(I'll Never Be) Maria Magdalena (BACKING M)	Sandra
(I'll Never Be) Maria Magdalena (Duett)	Sandra
(I'll Never Be) Maria Magdalena (Sandra)	Sandra
Into The Night	Santana feat. Chad Kroger
Smooth	Santana feat. Rob Thomas
María María	Santana feat. Wyclef Jean
Love Song	Sara Bareilles
Born To Fly	Sara Evans
Phantom of The Opera	Sarah Brightman & Michael Crawford
From Sarah With Love	Sarah Connor
Living to love you	Sarah Connor
Skin On Skin	Sarah Connor
The Best Side Of Life	Sarah Connor
I Remember Love	Sarah Dawn Finer
Angel	Sarah McLachlan
If you believe	Sasha
I Want You	Savage Garden
I Want You [VIDEO]	Savage Garden
To the Moon and Back	Savage Garden
Truly Madly Deeply	Savage Garden
Muscle Museum (live)	Scala & Kolacny Brothers
Seid bereit	Scar
Scatman's World	Scatman John
Das Schaferlied	Schafer Heinrich
Der Wandersmann	Schandmaul
Teufelsweib	Schandmaul
Willst du	Schandmaul
I Don't Feel Like Dancin'	Scissor Sisters
Laura	Scissor Sisters
Take your mama	Scissor Sisters
Break It Up	Scooter
One (Always Hardcore)	Scooter
Maria (I like it loud) [VIDEO]	Scooter vs. Marc Acardipane & Dick Rules
Send Me An Angel	Scorpions
Wind of Change	Scorpions
San Francisco	Scott McKenzie
Kiss From A Rose	Seal
Kiss From A Rose [VIDEO]	Seal
Beautiful Girls	Sean Kingston
Fire Burning	Sean Kingston
She Doesn't Mind	Sean Paul
Sommer Unseres Lebens	Sebastian Hämer
Ding	Seeed
Schwinger	Seeed
Chiquilla	Seguridad Social
Dreaming of You	Selena
Ist Es Wichtig?	Selig
Schau Schau	Selig
Closing Time	Semisonic
Brief is the light	Sentenced
Can't Get Over	September
Cry or you	September
Baw Mnie	Seweryn Krajewski
God Save The Queen	Sex Pistols
Desole'	Sexion d' Assaut
Angel	Shaggy
Boombastic	Shaggy
It wasn't me	Shaggy feat. Rik Rok
Don´t bother	Shakira
Gypsy	Shakira
She wolf	Shakira
Suerte	Shakira
Underneath Your Clothes	Shakira
Waka Waka (This Time for Africa)	Shakira
Whenever Wherever [VIDEO]	Shakira
Hips don´t lie [VIDEO]	Shakira ft. Wyclef
From this moment on	Shania Twain
It only hurts when i´m breathing	Shania Twain
She´s not just a pretty face	Shania Twain
Up!	Shania Twain
Loud	Shannon Noll
69	Shearer
69 (Kar)	Shearer
Can't stop it	Shearer
Can't stop it (Kar)	Shearer
Consequence Of Dawn	Shearer
In My Hand	Shearer
Man Song	Shearer
Man Song (Kar)	Shearer
Stay with me	Shearer
Stay with me (Kar)	Shearer
Strong Enough	Sheryl Crow
The First cut is the deepest	Sheryl Crow
One Night In Beijing [VIDEO]	Shin
Min Kärlek	Shirley Clamp
T-Shirt	Shontelle
Augen Auf	Sido
Das Beste	Silbermond
Durch die Nacht	Silbermond
Symphonie	Silbermond
Unendlich	Silbermond
My Heroine	Silverstein
Bridge Over Troubled Water	Simon & Garfunkel
Hazy Shade Of Winter	Simon & Garfunkel
Mrs. Robinson	Simon & Garfunkel
The Sound of Silence	Simon & Garfunkel
Don't You Forget About Me	Simple Minds
Untitled	Simple Plan
Welcome To My Life	Simple Plan
Your Love Is A Lie	Simple Plan
Nothing Compares 2 U [VIDEO]	Sinead O'Connor
Baby Got Back	Sir Mix A Lot
Baby Got Back	Sir Mix-a-Lot
We Are Family	Sister Sledge
We Are Family [VIDEO]	Sister Sledge
Liebeskummer Lohnt Sich Nicht	Siw Malmkvist
Kiss Me [VIDEO]	Sixpence None The Richer
Obud We Mnie Wenus	Sixteen
Twoja Lawa	Sixteen
Cannabis	Ska-P
Tio Sam	Ska-P
18 and Life	Skid Row
Awake and Alive	Skillet
Forgiven	Skillet
Hero	Skillet
Its Not Me Its You	Skillet
Monster	Skillet
Far Far Away	Slade
Merry Christmas everybody	Slade
Angel of death	Slayer
Raining blood	Slayer
I Wonder	Sleeping Beauty
Once Upon A Dream (Aurora)	Sleeping Beauty
Once Upon A Dream (Phillip)	Sleeping Beauty
Nazis raus	Slime
Before I Forget	Slipknot
Wait & Bleed	Slipknot
All Star	Smash Mouth
Walkin' on the Sun	Smash Mouth
Why Can't We Be Friends	Smash Mouth
Bullet With Butterfly Wings	Smashing Pumpkins
Cherub Rock	Smashing Pumpkins
Today	Smashing Pumpkins
Being With You	Smokey Robinson
The Tracks Of My Tears	Smokey Robinson & The Miracles
Living Next Door To Alice [VIDEO]	Smokie
Needles And Pins	Smokie
Who The Fuck Is Alice?	Smokie
Driver's Seat	Sniff'n the Tears
Chasing Cars	Snow Patrol
Run	Snow Patrol
Shut Your Eyes	Snow Patrol
Aber bitte mit Sahne	Sodom
Tainted Love	Soft Cell
Tainted Love [VIDEO]	Soft Cell
I Want You to Want Me	Solid Harmonie
The Cage	Sonata Arctica
Victoria's Secret	Sonata Arctica
I Got You Babe (Cher)	Sonny & Cher
I Got You Babe (Sonny)	Sonny & Cher
I Got You Babe	Sonny and Cher
För Att Du Finns	Sonya Aldén
Murder on the Dancefloor	Sophie Ellis Bextor
Murder on the Dancefloor (Karaoke)	Sophie Ellis Bextor
Murder on the Dancefloor (Karaoke) [VIDEO]	Sophie Ellis Bextor
Murder on the Dancefloor [VIDEO]	Sophie Ellis Bextor
Runaway Train	Soul Asylum
Kiss Me Through The Phone	Souljia Boy Ft. Sammie
Black Hole Sun	Soundgarden
Timmy and the Lords of the Underworld	South Park
In the Meantime	Spacehog
Gold	Spandau Ballet
2 Become 1 [VIDEO]	Spice Girls
Let Love Lead The Way	Spice Girls
Say You'll Be There	Spice Girls
Viva Forever	Spice Girls
Wannabe	Spice Girls
Wannabe [VIDEO]	Spice Girls
Who Do You Think You Are	Spice Girls
Skandal Im Sperrbezirk	Spider Murphy Gang
Two Princes	Spin Doctors
Two Princes [VIDEO]	Spin Doctors
Carbonara	Spliff
Theme (Deutsch)	Spongebob Schwammkopf
Theme	Spongebob Squarepants
54´74´90´2006	Sportfreunde Stiller
54´74´90´2010	Sportfreunde Stiller
Fast wie von selbst	Sportfreunde Stiller
Ich roque	Sportfreunde Stiller
Ich war noch niemals in New York	Sportfreunde Stiller & Udo Jürgens
Lukk Opp Din Hjertedør	Sputnik
Tempted	Squeeze
Gdy Zaplaczesz	Stachursky
Zostañmy Razem	Stachursky
Stuck [VIDEO]	Stacie Orrico
It's Been A While	Staind
No boy, no cry	Stance Punks
The Doctor - La donna é mobile	Star Trek Voyager
Nothing's Gonna Stop Us Now	Starship
Nothing's Gonna Stop Us Now [VIDEO]	Starship
We Built this City	Starship
In the Army now [VIDEO]	Status Quo
Rockin all over the world	Status Quo
Schwarze Natascha	Stefan Peters
Maschen-Draht-Zaun	Stefan Raab
Einer Ist Immer Der Loser	Stefan Remmler
Zu nah am Feuer	Stefan Waggershausen und Alice
My Man Is A Mean Man	Stefanie Heinzmann
Tian Hei Hei [VIDEO]	Stefanie Sun
Born To Be Wild	Steppenwolf
Born to be wild	Steppenwolf
Magic Carpet Ride	Steppenwolf
Deeper Shade Of Blue [VIDEO]	Steps
Liebe Zu Dritt	Stereo Total
Dakota	Stereophonics
Dakota [VIDEO]	Stereophonics
Walkie Talkie Man	Steriogram
Abracadabra	Steve Miller Band
Northern Star	Steven Dunston
For Once In My Life	Stevie Wonder
I just called to say I love you [VIDEO]	Stevie Wonder
Ebony And Ivory	Stevie Wonder Paul McCartney
English man in New York [VIDEO]	Sting
Fields of Gold	Sting
Fragile	Sting
Roxanne	Sting & The Police
Bother	Stone Sour
Plush	Stone Temple Pilots
Vasoline	Stone Temple Pilots
Take Me Back	Story Of The Year
Hände Hoch	Strandgeier
Santeria	Sublime
Discolabirinto	Subsonica
Incantevole	Subsonica
Nuvole Rapide	Subsonica
Erdbeermund	Subway To Sally
Kleid aus Rosen	Subway To Sally
Kleid aus Rosen (Akustik-Version)	Subway To Sally
Die Schlacht	Subway to Sally
Sag Dem Teufel	Subway to Sally
Overload	Sugababes
Push The Button	Sugababes
Push the button [VIDEO]	Sugababes
Red Dress	Sugababes
Round Round	Sugababes
Round Round (Karaoke)	Sugababes
Round Round (Karaoke) [VIDEO]	Sugababes
Round Round [VIDEO]	Sugababes
Too Lost In You	Sugababes
Too Lost In You [VIDEO]	Sugababes
Ugly [VIDEO]	Sugababes
Someday	Sugar Ray
Fat Lip	Sum 41
In Too Deep	Sum 41
Motivation	Sum 41
Pieces	Sum 41
Screaming Bloody Murder	Sum 41
The Hell Song	Sum 41
Dla Ciebie	Sumptuastic
Fairytale Gone Bad	Sunrise Ave
Fairytale Gone Bad	Sunrise Avenue
Fairytale Gone Bad [VIDEO]	Sunrise Avenue
Forever Yours	Sunrise Avenue
Heal me	Sunrise Avenue
Hollywood Hills	Sunrise Avenue
Dreamer	Supertramp
Logical Song	Supertramp
Eye Of The Tiger	Survivor
Eye Of The Tiger [VIDEO]	Survivor
I´m Always Here (Baywatch Theme)	Survivor
Strolch Ist Toll	Susi Und Strolch
Elokuun 11.	Suurlähettiläät
Luka [VIDEO]	Suzanne Vega
Don't You Worry Child	Swedish House Mafia & John Martin
Ballroom Blitz	Sweet
Turn The Tide	Sylver
Why Worry	Sylver
Aerials	System Of A Down
Byob Uncut!	System Of A Down
Hypnotize	System Of A Down
Lonely Day	System Of A Down
Question	System Of A Down
Revenga	System Of A Down
Soldier Side	System of A Down
B.Y.O.B.	System of a Down
Chop Suey	System of a down
Geh Davon Aus	SÃ¶hne Mannheims
Geh Davon Aus	Söhne Mannheims
Und Wenn Ein Lied	Söhne Mannheims
Und Wenn Ein Lied [VIDEO]	Söhne Mannheims
China In Your Hand	T'Pau
All About Us [VIDEO]	T.A.T.U.
All The Things She Said [VIDEO]	T.A.T.U.
Kyle Quit	TENACIOUS D
No Scrubs [VIDEO]	TLC
Dynamite	Taio Cruz
Back For Good	Take That
Back for Good	Take That
Patience	Take That
Relight My Fire	Take That feat. Lulu
Such A Shame	Talk Talk
Burning Down The House	Talking Heads
Gott ist tot	Tanz der Vampire
Totale Finsternis	Tanz der Vampire
So Ein Mann	Tarzan
Son Of Man	Tarzan
Sleeping Satellite	Tasmin Archer
Love Story	Taylor Swift
Our Song	Taylor Swift
Shout	Tears For Fears
Everybody Wants To Rule The World	Tears for Fears
Pump Up The Jam	Technotronic Feat. Felly
Pump Up The Jam	Technotronic feat. Felly
Mario	Tele
Batman Theme	Television
Fuck Her Gently [VIDEO]	Tenacious D
Tribute	Tenacious D
Sign you Name	Terence Trent D'Arby
yue liang dai biao wo de xin [VIDEO]	Teresa Teng
Girls Lie Too	Terri Clark
Seasons in the sun	Terry Jacks
Meng na li sha de yan lei [VIDEO]	Terry Lin
Summer Son	Texas
Summer Son [VIDEO]	Texas
No No Never	Texas Lightning
Dumb [VIDEO]	The 411
Gives You Hell	The All-American Rejects
Ramblin' Man	The Allman Brothers Band
Don'T Let Me Be Misunderstood	The Animals
House Of The Rising Sun	The Animals
Ev'rybody Wants To Be A Cat (Scat Cat)	The Aristocats
Ev'rybody Wants To Be A Cat (Tom)	The Aristocats
The Worrying Kind	The Ark
Boys Of Summer	The Ataris
Love Shack	The B-52's
(Meet) The Flintstones	The B.C. 52's
Walk Like An Egyptian	The Bangles
Umbrella	The Baseballs
Surfin USA	The Beach Boys
A Day in The Life	The Beatles
A Hard Day's Night	The Beatles
All My Loving	The Beatles
All You Need Is Love	The Beatles
Another Girl	The Beatles
Boys	The Beatles
Can't Buy Me Love	The Beatles
From Me To You	The Beatles
Good Morning, Good Morning	The Beatles
Hello, Goodbye	The Beatles
Help!	The Beatles
Helter Skelter	The Beatles
Her Majesty	The Beatles
Here, There And Everywhere	The Beatles
Hey Jude	The Beatles
I Saw Her Standing There	The Beatles
I Want To Hold Your Hand	The Beatles
In my life	The Beatles
Let It Be	The Beatles
Love Me Do	The Beatles
Michelle	The Beatles
Nowhere Man	The Beatles
Penny Lane	The Beatles
Please Please Me	The Beatles
Sgt. Pepper's Lonely Hearts Club Band	The Beatles
She Loves You	The Beatles
Strawberry Fields	The Beatles
The Night Before	The Beatles
Things We Said Today	The Beatles
Ticket To Ride	The Beatles
Twist And Shout	The Beatles
Yellow Submarine	The Beatles
Yesterday	The Beatles
You've Got To Hide Your Love Away	The Beatles
A Little Time	The Beautiful South
The Bad Touch	The Bloodhound Gang
The Ballad of Chasey Lane	The Bloodhound Gang
Uhn tiss uhn tiss uhn tiss	The Bloodhound Gang
Rawhide	The Blues Brothers
Don't Gimme That	The BossHoss
An Honest Mistake	The Bravey
Gummi Bears	The Brown Derbies
Wherever You Will Go	The Calling
Wherever You Will Go [VIDEO]	The Calling
Erase and rewind	The Cardigans
Lovefool	The Cardigans
Lovefool [VIDEO]	The Cardigans
My Favourite Game	The Cardigans
My Favourite Game [VIDEO]	The Cardigans
Drive	The Cars
Lollipop	The Chordettes
Should I Stay Or Should I Go	The Clash
Should I Stay Or Should I Go [VIDEO]	The Clash
Brick House	The Commodores
Easy	The Commodores
Nightshift	The Commodores
74,75	The Connells
Do You Love Me (BACKING M)	The Contours
Do You Love Me (Billy)	The Contours
Breathless	The Corrs
So Young	The Corrs
The Right Time	The Corrs
Ode To My Family	The Cranberries
Promises	The Cranberries
When You're Gone	The Cranberries
Zombie	The Cranberries
Zombie [VIDEO]	The Cranberries
Ooh I Like It	The Creeps
A Letter To Elise	The Cure
Close to me	The Cure
Friday I'm In Love	The Cure
In between days	The Cure
Just Like Heaven	The Cure
Bohemian Like You	The Dandy Warhols
I Believe In A Thing Called Love [VIDEO]	The Darkness
I Believe in a Thing Called Love	The Darkness
I Believe in a Thing Called Love (Karaoke)	The Darkness
For You	The Disco Boys
I Touch Myself	The Divinyls
Break On Through	The Doors
Break on through [VIDEO]	The Doors
House Of The Rising Sun	The Doors
Light my Fire	The Doors
People Are Strange	The Doors
Riders On The Storm	The Doors
Hotel California	The Eagles
Here comes the rain again	The Eurythmics
There Must Be An Angel	The Eurythmics
Bye bye love	The Everly Brothers
Dream, Dream, Dream	The Everly Brothers
Aquarius (Let The Sunshine In)	The Fifth Dimension
Everytime	The Flames
Everytime [VIDEO]	The Flames
Build Me Up Buttercup	The Foundations
Build Me Up Buttercup [VIDEO]	The Foundations
Reach Out I'll Be There (BACKING M)	The Four Tops
Reach Out I'll Be There (Levi)	The Four Tops
How To Save A Life	The Fray
Hate To Say I Told You So	The Hives
Main Offender	The Hives
Tick Tick Boom	The Hives
Johnny B	The Hooters
This Old Heart Of Mine	The Isley Brothers
ABC (Jackson 5)	The Jackson 5
ABC (Michael)	The Jackson 5
I Want You Back	The Jackson 5
Bare Necessities	The Jungle Book
I Wanna Be Like You (Baloo)	The Jungle Book
I Wanna Be Like You (Louis)	The Jungle Book
An Angel	The Kelly Family
Fell In Love With An Alien	The Kelly Family
I Can't Help Myself	The Kelly Family
Nanana	The Kelly Family
Roses of Red	The Kelly Family
When The Last Tree	The Kelly Family
Forelska i lærer'n	The Kids
Human	The Killers
Mr. Brightside	The Killers
Somebody Told Me	The Killers
When You Were Young	The Killers
Lola	The Kinks
Sunny Afternoon	The Kinks
Waterloo Sunset	The Kinks
My Sharona	The Knack
Circle Of Life (Backing)	The Lion King
Circle Of Life (Lead)	The Lion King
I Just Can't Wait To Be King	The Lion King
Kiss The Girl (Backing)	The Little Mermaid
Kiss The Girl (Sebastian)	The Little Mermaid
Under The Sea	The Little Mermaid
Jizz In My Pants	The Lonely Island
I Just Had Sex	The Lonely Island ft. Akon
Jack Sparrow	The Lonely Island ft. Michael Bolton
California Dreamin' (Duett)	The Mamas and the Papas
California Dreaming	The Mamas and the Papas
Hare Hare Yukai	The Melancholy of Haruhi Suzumiya
Hare Hare Yukai (Gundam Ver)	The Melancholy of Haruhi Suzumiya
Love Machine	The Miracles
I miss you like crazy	The Moffatts
Daydream Believer	The Monkees
I'm A Believer	The Monkees
Sunday People	The Monroes
All Along	The Offspring
All I Want	The Offspring
Hit that	The Offspring
Leave it behind	The Offspring
Original Prankster	The Offspring
Pretty Fly [VIDEO]	The Offspring
Self Esteem	The Offspring
Self Esteem [VIDEO]	The Offspring
Spare Me the Details	The Offspring
The Kids aren't alright	The Offspring
The Meaning of Life	The Offspring
Why don't you get a job [VIDEO]	The Offspring
You're Gonna Go Far Kid	The Offspring
Your Love	The Outfield
Only You	The Platters
Smoke gets into your eyes	The Platters
The great pretender	The Platters
Dirty Old Town	The Pogues
Fairytale of New York	The Pogues feat. Kirsty MacColl
Every Breath You Take	The Police
Every Breath You Take [VIDEO]	The Police
Every Little Thing She Does Is Magic	The Police
Roxanne	The Police
Roxanne [VIDEO]	The Police
So Lonely	The Police
Walking on the moon	The Police
Night Of Passion	The Poodles
I'm gonna be (500 Miles)	The Proclaimers
No Good (Start the Dance)	The Prodigy
Buttons [VIDEO]	The Pussycat Dolls
Don't Cha (Radio Edit) [VIDEO]	The Pussycat Dolls
Stick Wit U [VIDEO]	The Pussycat Dolls
Sway	The Pussycat Dolls
Beep [VIDEO]	The Pussycat Dolls (Feat. Will.i.am)
In the Shadows [VIDEO]	The Rasmus
Livin´ In A World Without You	The Rasmus
No fear	The Rasmus
I'll be there for you	The Rembrandts
Unchained Melody	The Righteous Brothers
Unchained Melody [VIDEO]	The Righteous Brothers
Angie	The Rolling Stones
Paint It, Black	The Rolling Stones
Satisfaction	The Rolling Stones
Sympathy For The Devil	The Rolling Stones
Wind of Change	The Scorpions
Hall Of Fame	The Script feat. Will.I.Am
Cries Like A Baby	The September When
See My Vest	The Simpsons
When You Don´t See Me	The Sisters of Mercy
Girlfriend in a Coma	The Smiths
This Charming Man	The Smiths
This Charming Man [VIDEO]	The Smiths
You just haven't earned it yet, Baby	The Smiths
No One Sleeps When I'm Awake	The Sounds
My Boyfriend's Back	The Spazzys
Ghost Town	The Specials
Waterfall [VIDEO]	The Stone Roses
Golden Brown	The Stranglers
Rock and Roll Queen	The Subways
You Can't Hurry Love	The Supremes
Teenage Rampage	The Sweet
Get Ready (BACKING M)	The Temptations
Get Ready (Eddie)	The Temptations
My Girl	The Temptations
Papa Was A Rollin' Stone	The Temptations
The lion sleeps tonight	The Tokens
End of the line	The Traveling Wilburys
Handle With Care	The Traveling Wilburys
Teenage Kicks	The Undertones
Needle In A Haystack (BACKING F)	The Velvelettes
Needle In A Haystack (Bertha)	The Velvelettes
Hook me up	The Veronicas
Untouched	The Veronicas
Bitter Sweet Symphony [VIDEO]	The Verve
YMCA	The Village People
YMCA (Karaoke)	The Village People
YMCA (Karaoke) [VIDEO]	The Village People
It's Raining Men	The Weather Girls
Hotel Yorba	The White Stripes
I Just Don't Know What To Do With Myself	The White Stripes
Seven Nation Army	The White Stripes
Baba O'Riley	The Who
Pinball Wizard	The Who
We had joy we had fun	The mamas and the papas
All Or Nothing	Theory Of A Deadman
The Boys Are Back In Town	Thin Lizzy
The boys are back in town	Thin Lizzy
20 Good Reasons	Thirsty Merc
Love Is You	Thomas Godoj
Doctor! Doctor!	Thompson Twins
Hold Me Now	Thompson Twins
Good Life	Three Days Grace
I Hate Everything About You	Three Days Grace
I Think We're Alone Now	Tiffany
Run¹³ Ju¿ Ostatni Mur	Tilt
Nur Noch Kurz Die Welt Retten	Tim Bendzko
Bobfahrerlied	Tim Toupet
Da sprach der Scheich zum Emir	Tim Toupet
Ein Diamant	Tim Toupet
Ich Bin Ein Doner	Tim Toupet
So Ein Schoner Tag Fliegerlied	Tim Toupet
So Ein Schöner Tag (Fliegerlied)	Tim Toupet
The Way I Are (feat. Keri Hilson)	Timbaland
Apologize [VIDEO]	Timbaland Feat. One Republic
Morning After Dark	Timbaland feat. SoShy & Nelly Furtado
Chains	Tina Arena
Golden Eye	Tina Turner
The Best	Tina Turner
What's Love Got To Do With It	Tina Turner
What's Love Got To Do With It?	Tina Turner
Vil ha deg	Tine
Amore Impossibile	Tiromancino
Imbranato	Tiziano Ferro
Non me lo so spiegare	Tiziano Ferro & Laura Pausini
I Still Burn	Tobias Regner
Die Welt kann mich nicht mehr verstehen	Tocotronic
Dieses Jahr	Tocotronic
Freiburg V3.0 [Original]	Tocotronic
Let There Be Rock	Tocotronic
Sie wollen uns erzählen	Tocotronic
This Boy Is Tocotronic	Tocotronic
Wir Sind Hier Nicht In Seattle, Dirk	Tocotronic
An Deiner Seite	Tokio Hotel
An Deiner Seite [VIDEO]	Tokio Hotel
Durch Den Monsun	Tokio Hotel
Krüppel und Schwul [VIDEO]	Tokio Hotel
Monsoon [VIDEO]	Tokio Hotel
Schrei	Tokio Hotel
It's Not Unusual	Tom Jones
It's Not Unusual [VIDEO]	Tom Jones
Sexbomb	Tom Jones
Sexbomb (Karaoke)	Tom Jones
green green grass of home	Tom Jones
Wunder Gibt Es Immer Wieder	Tom Kruse
Free Fallin'	Tom Petty
Into The Great Wide Open	Tom Petty
En Dag	Tommy Nilsson
Ich Sang Die Ganze Zeit Von Dir	Tomte
Es muss nur weit sein	Toni Kater
Toni & Tobi	Toni Kater
Amarillo	Tony Christie
Schone Maid	Tony Marshall
Sober	Tool
Dancing in the Moonlight [VIDEO]	Toploader
Beinhart	Torfrock
ï»¿#TITLE:Beinhart	Torfrock
Africa	Toto
Africa [VIDEO]	Toto
Hold The Line	Toto
Hold the line	Toto
Rosanna	Toto
Tarzan & Jane (Jane Version)	Toy Box
Tarzan & Jane (Tarzan Version)	Toy Box
Du Hast 'N Freund In Mir	Toy Story
You Got A Friend In Me	Toy Story
Honky Tonk Badonkadonk	Trace Adkins
You're Gonna Miss This	Trace Adkins
Baby can i hold	Tracy Chapman
O Holy Night	Tracy Chapman
O Tannenbaum	Traditional
A Storm At Will	Trail of Tears
Sing	Travis
Anna (Lassmichreinlassmichraus)	Trio
Da Da Da [VIDEO]	Trio
New York, Rio, Tokyo	Trio Rio
We're Not Gonna Take It	Twisted Sister
Beautiful Day	U2
Elevation	U2
I Still Haven't Found What I'm Looking For	U2
One	U2
Pride	U2
Sweetest Thing	U2
The Sweetest Thing	U2
Vertigo	U2
With or without you	U2
The Saints Are Coming	U2 & Green Day
Mama	US5
D-tecnoLife	UVERworld
17 Jahr	Udo Jürgens
Aber bitte mit Sahne	Udo Jürgens
Griechischer Wein	Udo Jürgens
Ich war noch niemals in New York	Udo Jürgens
Ich weiß, was ich will	Udo Jürgens
Lieb Vaterland	Udo Jürgens
Ein Herz kann man nicht repariern	Udo Lindenberg
Sonderzug nach Pankow	Udo Lindenberg
You Can't Run Away	Udo Lindenberg feat. Freundeskreis
Cats in the Cradle	Ugly Kid Joe
Free	Ultra Nate
Dancing With Tears In My Eyes	Ultravox
balla	Umberto Balsamo
Gloria	Umberto Tozzi
Si Può Dare Di Più	Umberto Tozzi & Gianni Morandi & Enrico Ruggeri
Follow Me	Uncle Kracker
Geboren um zu leben	Unheilig
Lady In Black	Uriah Heep
More (Redone Jimmy Joker Remix)	Usher
Yeah	Usher Ft Lil Jon & Ludacris
DJ Got Us Falling In Love Again	Usher ft. Pitbull
Colors of Hearts (BLOOD+)	Uverworld
Bananowy Song	VOX
Das Lied der Schlümpfe	Vader Abraham
Tre Parole	Valeria Rossi
Jump	Van Halen
Have I told you lately	Van Morrison
Thousand Miles	Vanessa Carlton
Ice Ice Baby	Vanilla Ice
Albachiara	Vasco Rossi
C'è Chi Dice No	Vasco Rossi
Come Stai	Vasco Rossi
Gioca Con Me	Vasco Rossi
Ogni volta	Vasco Rossi
Sally	Vasco Rossi
Siamo Soli	Vasco Rossi
Splendida giorna	Vasco Rossi
Vita Spericolata	Vasco Rossi
Vivere	Vasco Rossi
Das Lied Der Schlümpfe	Vater Abraham
What's A Woman	Vaya Con Dios
Boom boom boom boom	Vengaboys
Shalalalala	Vengaboys
We're going to Ibiza!	Vengaboys
Y.M.C.A.	Village People
Summer Wine	Ville Valo & Natalia Avelon
Szansa	Virgin
Znak Pokoju	Virgin
Mehr Als Das	Virginia Jetzt
Fade to grey	Visage
Maybelenne I hofteholder	Volbeat
Radio girl	Volbeat
All That She Wants	WIZO
Poupée De Cire	WIZO
Roy Black ist tot	WIZO
Lets Have A Party	Wanda Jackson
Lao shu ai da mi [VIDEO]	Wang Qi Wen
Indigo Girl	Watershed
Buddy Holly	Weezer
Keep Fishin'	Weezer
Weezer - Say It Ain't So	Weezer
Achy Breaky Song	Weird Al Yankovic
Amish Paradise	Weird Al Yankovic
Bohemian Polka	Weird Al Yankovic
Jurassic Park	Weird Al Yankovic
On Ebay	Weird Al Yankovic
Smells Like Nirvana	Weird Al Yankovic
White & Nerdy	Weird Al Yankovic
Er Hat Ein Knallrotes Gummiboot	Wencke Myrhe
Johnny Walker (Live)	Westernhagen
Willenlos	Westernhagen
If I Let You Go	Westlife
My love	Westlife
World of Our Own	Westlife
World of Our Own (Karaoke)	Westlife
You raise me up	Westlife
Love Is All Around	Wet Wet Wet
Club Tropicana	Wham
Wake Me Up Before You Go-Go	Wham
Last Christmas	Wham!
Wake Me Up Before You Go-Go	Wham!
Teenage Dirtbag	Wheatus
Saturday Night	Whigfield
Here I go again	Whitesnake
Greatest Love Of All	Whitney Houston
I Wanna Dance With Somebody	Whitney Houston
I Will Always Love You	Whitney Houston
My Love Is Your Love	Whitney Houston
One moment in time	Whitney Houston
Do they know it's Christmas	Wichtel Aid
I'm not that Girl	Wicked
Saturday Night	Wigfield
Men In Black	Will Smith kai
Switch It On	Will Young
Pancho And Lefty	Willie Nelson
Mitten Im Hundert-Morgen-Wald	Winnie Puuh
Winnie The Pooh	Winnie The Pooh
Aurelie	Wir Sind Helden
Denkmal	Wir Sind Helden
Nur Ein Wort	Wir Sind Helden
Soundso	Wir Sind Helden
Von hier an blind	Wir Sind Helden
Wenn es passiert	Wir Sind Helden
Lebendig und kräftig und schärfer	Wise Guys
Mensch, wo bist du?	Wise Guys
Mensch, wo bist du? (Karaoke)	Wise Guys
Stand My Ground	Within Tempation
Ice queen	Within Temptation
Die Flut (Duett)	Witt ft. Heppner
Nix und Niemand	Wizo
Schifoan	Wolfgang Ambros
Auf den Mond schiessen	Wolfgang Petry
Augen zu und durch	Wolfgang Petry
Bronze, Silber Und Gold (Live)	Wolfgang Petry
Gianna	Wolfgang Petry
Laßt Uns Froh Und Munter sein.mp3	Wolfgang Petry
Ruhrgebiet	Wolfgang Petry
Verlieben,verloren,vergessen,verzeihn	Wolfgang Petry
Wahnsinn	Wolfgang Petry
Kein zurück	Wolfsheim
Once In A Lifetime	Wolfsheim
Teardrops	Womack And Womack
Beyond Her Garden	WoodenToaster
A Neverending Dream	X-Perience
Abschied nehmen	Xavier Naidoo
Dieser Weg [VIDEO]	Xavier Naidoo
Wo Willst Du Hin	Xavier Naidoo
Zeilen Aus Gold	Xavier Naidoo
Ich Kenne Nichts	Xavier Naidoo feat. RZA
Again	YUI
New Soul	Yael Naim & David Donatien
The Only Way Is Up	Yazz
Gold Lion	Yeah Yeah Yeahs
Oh Yeah	Yello
Life Of A Salesman	Yellowcard
Ocean Avenue	Yellowcard
Way Away	Yellowcard
Owner Of A Lonely Heart	Yes
Child In Time	Yngwie J. Malmsteen
Rising Force	Yngwie J. Malmsteen
Cruel Angel's Thesis	Yoko Takahashi
A Kiss Is All I Miss	Yoomiii
Für Dich	Yvonne Catterfeld
Sag Mir, Was Meinst Du?	Yvonne Catterfeld
Joutsenlaulu	Yö
Gimme All Your Lovin	ZZ Top
Breaking free	Zac Efron and Vanessa Anne Hudgens (High School Musical)
In The Year 2525	Zager & Evans
Seit Mehr Als 1000 Jahren	Zascha
Cha³upy Welcome To	Zbigniew Wodecki
Playmate Of The Year	Zebrahead
svegliarsi la mattina	Zero Assoluto
Zuo zai xiang kou de na dui nan nv [VIDEO]	Zi ran juan
Ich Vermiss Dich Wie Die Hölle	Zlatko
Großer Bruder	Zlatko & Jürgen
Baila Morena	Zucchero
Con Le Mani	Zucchero
Diamante	Zucchero
Donne	Zucchero
Il grande baboomba	Zucchero
Hunting High And Low	a-ha
Ganz egal	böhse onkelz
Vorrei	lunapop
Ö la Palöma	Ö la Palöma Boys
